ā	āia
ahu	ahuria
ahuahu	ahuahungia
ai	aitia
āki	ākina
akiaki	akiakina
ākiri	ākiritia
ākirikiri	ākirikiritia
ako	akona
āmi	āmitia
āmine	āminengia
amo	amohia
amuamu	amuamutia
ao	aohia
apiti	apitiria
āpiti	āpitiria
apo	apohia
apoapo	apoapohia
apu	apuria
āpuru	āpurua
ara	arahia
arahi	arahina
ārahi	ārahina
ārai	āraia
arataki	aratakina
aro	arongia
aroha	arohaina
aru	arumia
aruaru	aruarumia
atawhai	atawhaitia
ātete	ātetetia
ato	atohia
auē	auētia
aukaha	aukahatia
auru	aurutia
aweke	aweketia
awhe	awhea
awhi	awhitia
awhina	awhinatia
āwhina	āwhinatia
āwhio	āwhiotia
ehu	ehua
eke	ekea
epa	epaina
haehae	haehaea
haere	haerea
hahau	hahautia
hāhau	hāhautia
hahu	hahua
haina	hainatia
haka	hakaa
hākere	hākerea
haku	hakua
hakuhaku	hakuhakua
hāmene	hāmenetia
hane	hanea
hanga	hangaa
hao	haoa
hāpai	hāpainga
hari	haria
hauhake	hauhaketia
haupapa	haupapatia
hāwhe	hāwhetia
heke	hekea
here	herea
herehere	hereherea
heru	herua
heu	heua
heuheu	heuheutia
hī	hīa
hiahia	hiahiatia
hīanga	hīangatia
hihira	hihiratia
hihiri	hihiritia
hika	hikaia
hiki	hikitia
hiko	hikoia
hinga	hingana
hīpoki	hīpokina
hīrau	hīrautia
hīri	hīritia
hirihiri	hirihiria
hiwi	hiwia
hoe	hoea
hohou	hohoutia
hoki	hokia
hoko	hokona
hokohoko	hokohokona
hokomirimori	hokomirimoria
hongi	hongia
hongihongi	hongihongia
hono	honoa
hopu	hopukia
hora	horahia
hori	horia
horo	horoa
horo	horomia
horoi	horoia
horomi	horomia
hou	houhia
houhou	houhoua
hua	huaia
hua	huaina
huaki	huakina
huhu	huhua
hui	huia
huihui	huihuia
huke	hukea
huki	hukia
hukihuki	hukihukia
hume	humea
huna	hunaa
hunu	hunua
hunuhunu	hunuhunua
hūpeke	hūpeketia
hura	hurahia
huri	hurihia
huru	hurua
huti	hutia
iheuheu	iheuheua
ihi	ihia
ihiihi	ihiihia
inaki	inakitia
inoi	inoia
inu	inumia
iri	iria
kā	kāngia
kahaki	kahakina
kāhaki	kāhakina
kai	kainga
kaingākau	kaingākautia
kaiponu	kaiponuhia
kahu	kahuria
kākahu	kākahuria
kakaro	kakarohia
kakau	kakauria
kake	kakea
kanga	kangaa
kape	kapea
kapi	kapia
kapo	kapohia
kāpui	kāpuia
karakia	karakiatia
karanga	karangahia
karapoti	karapotia
karawhiu	karawhiua
kare	karea
kari	karia
karo	karohia
kata	kataina
kati	katia
kato	katohia
kau	kauria
kauhoe	kauhoetia
kaui	kauitia
kaumātua	kaumātuatia
kaupare	kauparea
kauwhau	kauwhautia
kawe	kawea
kāwhaki	kāwhakina
kāwiri	kāwiritia
keri	keria
ketu	ketua
ketuketu	ketuketua
keu	keua
kī	kīa
kihi	kihia
kiki	kikia
kikini	kikinitia
kimi	kimihia
kini	kinitia
kite	kitea
ko	koia
kō	kōia
koa	koaina
koara	koaratia
kōhari	kōharitia
kohi	kohia
kohikohi	kohikohia
kōhua	kōhuatia
kōhue	kōhuetia
kōhure	kōhurea
kōhuru	kōhurutia
koingo	koingotia
kōkiri	kōkiritia
koko	kokoa
kōmiri	kōmiria
komo	komotia
komutu	komutua
kōnatu	kōnatua
kōpake	kōpaketia
kōpaki	kōpakina
kopani	kopania
kōpani	kōpania
kōpare	kōparea
kōpenu	kōpenutia
kōpenupenu	kōpenupenutia
kopi	kopia
kōpiro	kōpiroa
kōranga	kōrangatia
kōrero	kōrerotia
koro	koroa
kōrori	kōroria
korou	koroutia
kote	kotehia
kōti	kōtia
kōtui	kōtuia
kowhaki	kowhakina
kowhete	kowhetetia
kōwhiri	kōwhiria
kōwhiti	kōwhitihia
kuhu	kuhua
kuku	kukua
kume	kumea
kumu	kumua
kuru	kurua
kuti	kutia
mahanga	mahangatia
mahara	maharatia
māharahara	māharaharatia
mahi	mahia
mahimahi	mahimahia
maka	makaa
mākiri	mākirihia
mākutu	mākuturia
maminga	mamingatia
manaaki	manaakitia
manako	manakohia
mania	maniaa
mapu	mapua
mārau	māraua
mārena	mārenatia
maro	marohia
mātaki	mātakina
mātakitaki	mātakitakina
mātau	mātauria
mate	matea
mau	mauria
māunu	māunutia
mea	meatia
meke	mekea
mekemeke	mekemekehia
memeke	memekehia
mīharo	mīharotia
mihi	mihia
minita	minitatia
miraka	mirakatia
miri	miria
miro	miroa
miti	mitia
mitimiti	mitimitia
moe	moea
mōhio	mōhiotia
mōkete	mōketetia
momi	momia
mono	monokia
moto	motokia
motu	motuhia
mōunu	mōunutia
mui	muia
muimui	muimuia
muku	mukua
mukumuku	mukumukua
muna	munaia
muru	murua
mutumutu	mutumutua
nanao	nanaomia
nao	naomia
narunga	narungatia
nati	natia
natu	natua
nēhi	nēhitia
nehu	nehua
neke	nekehia
nekeneke	nekenekehia
ngahu	ngahua
ngaki	ngakia
ngare	ngarea
ngaro	ngaromia
ngau	ngaua
ngaungau	ngaungaua
ngote	ngotea
niko	nikoa
noa	noatia
noho	nohoia
nuka	nukaia
nukarau	nukarautia
nuku	nukuhia
nukunuku	nukunukuhia
numi	numia
numu	numua
oati	oatitia
oka	okaina
oke	okea
oma	omakia
onioni	onionitia
ono	onokia
opa	opaina
ore	orea
oro	orohia
ota	otaina
pā	pāngia
pae	paea
pāera	pāeratia
pāhua	pāhuatia
pai	paingia
paihere	paiheretia
paikarāihe	paikarāihetia
pāike	pāikea
paka	pakatia
pakanga	pakangatia
pākaru	pākarua
pākarukaru	pākarukarua
pākawe	pākawetia
pana	panaa
panga	pangaa
pani	pania
panipani	panipania
pānui	pānuitia
pao	paoa
paora	paoratia
paoro	paorotia
parai	paraitia
parakitihi	parakitihitia
parani	paranitia
parau	parautia
pare	parea
paro	paroa
pātai	pātaia
pati	patia
patō	patōhia
patu	patua
pauna	paunatia
pāuna	pāunatia
paura	pauratia
pāwhara	pāwharatia
pēhea	pēheatia
pēhi	pēhia
pehipehi	pehipehia
pei	peia
peka	pekaina
pēke	pēketia
pēnā	pēnātia
pēnei	pēneitia
pērā	pērātia
pere	perea
perehi	perehitia
pīangi	pīangitia
pīkau	pīkautia
piki	pikitia
piko	pikoa
pine	pinea
pīnohi	pīnohitia
pīoi	pīoitia
piro	pirongia
piu	piua
piupiu	piupiua
pō	pōngia
pōhēhē	pōhēhētia
pōhiri	pōhiritia
poipoi	poipoia
poka	pokaia
pōkai	pōkaia
poke	pokea
pokuru	pokurua
pona	ponaia
popo	popotia
pōpopo	pōpopotia
pōrangi	pōrangitia
poro	poroa
poroporo	poroporotia
pororua	pororuatia
porowhiu	porowhiua
pōtae	pōtaea
pōti	pōtitia
pou	poua
pōuto	pōutokia
pōwhiri	pōwhiritia
pū	pūia
puare	puaretia
pūāwai	pūāwaitia
pūawhe	pūawhea
puhi	puhia
pūkai	pūkaitia
punga	pungaa
pūranga	pūrangatia
purei	pureitia
pūremu	pūremutia
puri	puritia
puru	purua
puruma	purumatia
purūma	purūmatia
purupuru	purupurua
puta	putaina
raho	rahoa
rahoraho	rahorahoa
rahu	rahua
rāhui	rāhuitia
raka	rakatia
rākei	rākeitia
rama	ramaa
ranga	rangaa
rangahau	rangahaua
rangirangi	rangirangia
ranu	ranua
rapa	rapangia
rapi	rapihia
rāpoi	rāpoia
rapu	rapua
rara	raraa
rārangi	rārangitia
rarapi	rarapihia
rarawhi	rarawhia
rau	raua
raupatu	raupatutia
rautao	rautaongia
raweke	raweketia
rāwhera	rāwheratia
rawhi	rawhia
rehe	rehea
rēhita	rēhitatia
rehu	rehua
rere	rerengia
rewherī	rewherītia
rīhi	rīhitia
ringi	ringihia
rīngi	rīngihia
rīpeka	rīpekatia
ripi	ripia
riri	riria
riringi	riringihia
rohe	rohea
romi	romia
rongo	rongohia
rongonui	rongonuitia
ropi	ropia
rore	rorea
rori	roria
rotu	rotua
ruaki	ruakina
rui	ruia
ruke	rukehia
ruku	rukuhia
rumaki	rumakina
runa	runaa
rure	rurea
rurerure	rurerurea
rūri	rūritia
rūrū	rūrūhia
ruruku	rurukutia
rutu	rutua
tā	tāngia
tae	taea
tāhae	tāhaetia
tāhawahawa	tāhawahawatia
tahi	tahia
tahitahi	tahitahia
tahu	tahuna
taiapo	taiapotia
taiapu	taiaputia
taiari	taiaritia
taitai	taitaia
taka	takaina
takahi	takahia
takai	takaia
takakino	takakinotia
takapapa	takapapaa
takapau	takapauria
tākaro	tākarohia
takawiri	takawiritia
take	takea
tāke	tāketia
taki	takina
tākiri	tākiritia
takitaki	takitakina
takoto	takotoria
tāmaru	tāmarutia
tāmau	tāmautia
tāmi	tāmia
tāmuimui	tāmuimuia
tamumu	tamumutia
tānapu	tānaputia
tangi	tangihia
tango	tangohia
tanu	tanumia
tānumi	tānumitia
tao	taona
tāoro	tāoroa
tapa	tapaia
tāpae	tāpaea
tapa	tapahia
tapahi	tapahia
tāpapa	tāpapatia
tāpāpā	tāpāpātia
tapatapa	tapatapaia
tapatapahi	tapatapahia
tāpatu	tāpatutia
tapi	tapia
tāpi	tāpia
tapiki	tapikitia
tāpiri	tāpiritia
tapuhi	tapuhitia
tāpui	tāpuia
tāpuke	tāpuketia
tāpuni	tāpunia
tarai	taraia
tārai	tāraia
taraiwa	taraiwatia
tare	tarea
tari	taria
tārona	tāronatia
tatā	tatāngia
tātai	tātaia
tātāmi	tātāmia
tātari	tātaritia
tatau	tatauria
tātāwhi	tātāwhia
tātua	tātuatia
tau	tauria
taua	tauatia
tauaarai	tauaaraitia
tauapo	tauapohia
tauhere	tauherea
taumau	taumautia
taunaha	taunahatia
taunga	taungatia
taupare	tauparea
taupoki	taupokina
tautohe	tautohetia
tautohetohe	tautohetohetia
tautoko	tautokona
tauwehe	tauwehea
tāuwhi	tāuwhia
tāwai	tāwaia
tāwharau	tāwharautia
tāwhi	tāwhia
tāwhio	tāwhiotia
tāwhiri	tāwhiritia
tāwhiu	tāwhiua
tia	tiaina
tiaki	tiakina
tīhae	tīhaea
tīhore	tīhorea
tīkaro	tīkarohia
tiki	tikina
tīkoko	tīkokoa
tīmata	tīmataria
timere	timerea
tinei	tineia
tinihanga	tinihangatia
tipu	tipua
tiriwa	tiriwatia
tiriwā	tiriwātia
tiro	tirohia
tītama	tītamatia
tītari	tītaria
titi	titia
titoko	titokona
tītokotoko	tītokotokona
tītore	tītorea
tiu	tiua
tīwara	tīwarahia
tō	tōkia
tohatoha	tohatohaina
tohe	tohea
tohi	tohia
tōhi	tōhitia
tohu	tohua
tohu	tohungia
tohu	tohuria
tōkari	tōkaritia
tokotoko	tokotokona
tomo	tomokia
tono	tonoa
tope	topea
toro	torona
tou	toua
toutou	toutoua
tū	tūria
tua	tuaina
tūā	tūāina
tūahu	tūahutia
tuaki	tuakina
tuhi	tuhia
tuhituhi	tuhituhia
tūhono	tūhonoa
tui	tuia
tuitui	tuituia
tuketuke	tuketukea
tuki	tukia
tūkino	tūkinotia
tuku	tukua
tukutuku	tukutukua
tūmanako	tūmanakohia
tungi	tungia
tunu	tunua
tunutunu	tunutunua
tupehau	tupehaukia
tupeke	tupeketia
tūpeke	tūpeketia
tupoki	tupokina
tupu	tupuria
tupua	tupuatia
turaki	turakina
turuki	turukitia
tūtaki	tūtakina
tute	tutea
tutu	tutua
tūtui	tūtuia
tuwha	tuwhaia
tuwhera	tuwheratia
tūwhiti	tūwhititia
ua	uaina
uara	uaratia
ui	uia
uiui	uiuia
uku	ukuia
ukui	ukuia
umere	umeretia
unga	ungaa
unu	unuhia
unu	unumia
uru	urua
urungi	urungitia
uruumu	uruumutia
uta	utaina
utu	utua
ūtonga	ūtongatia
uwhi	uwhia
uwhiuwhi	uwhiuwhia
wāhi	wāhia
wāwāhi	wāwāhia
waea	waeatia
waere	waerea
waha	wahaa
wai	waia
waiata	waiatatia
waiho	waihotia
waikeri	waikeringia
waimeha	waimehatia
waipuke	waipuketia
wani	wania
ware	warea
wareware	warewaretia
waru	waruhia
wawae	wawaea
wawata	wawatatia
wehe	wehea
wehewehe	wehewehea
weku	wekua
wepu	wepua
wero	werohia
wete	wetekia
wetewete	wetewetekia
whāki	whākina
whānako	whānakohia
whāngai	whāngaia
whāriki	whārikitia
whai	whaia
whaiere	whaieretia
whaikōrero	whaikōrerotia
whaina	whainatia
whaiwhai	whaiwhaia
whakaae	whakaaetia
whakaahu	whakaahutia
whakaahua	whakaahuatia
whakaahuru	whakaahurutia
whakaakakahu	whakaakakahuria
whakaako	whakaakona
whakaako	whakaakoria
whakaara	whakaarahia
whakaari	whakaaria
whakaaro	whakaarotia
whakaatamira	whakaatamiratia
whakaatu	whakaaturia
whakaea	whakaeatia
whakaeaea	whakaeaeatia
whakaeke	whakaekea
whakaemi	whakaemihia
whakaene	whakaenetia
whakaero	whakaerotia
whakahāwe	whakahāwea
whakahāwea	whakahāweatia
whakahaere	whakahaerea
whakahake	whakahaketia
whakahanumi	whakahanumitia
whakahau	whakahaua
whakahē	whakahēngia
whakaheke	whakahekea
whakahemo	whakahemoa
whakahere	whakaherea
whakahinga	whakahingaia
whakahoa	whakahoatia
whakahohori	whakahohoritia
whakahohoro	whakahohorotia
whakahoki	whakahokia
whakahōnore	whakahōnoretia
whakahori	whakahoria
whakahoro	whakahoroa
whakahorohoro	whakahorohorotia
whakahua	whakahuatia
whakaihi	whakaihia
whakaingoa	whakaingoatia
whakainu	whakainumia
whakaipo	whakaipotia
whakaipoipo	whakaipoipotia
whakairi	whakairia
whakairo	whakairohia
whakaiti	whakaitia
whakakā	whakakāngia
whakakaha	whakakahangia
whakakahaki	whakakahakitia
whakakāhore	whakakāhoretia
whakakai	whakakairia
whakakakara	whakakakaratia
whakakake	whakakakea
whakakāniwha	whakakāniwhatia
whakakao	whakakaotia
whakakapi	whakakapia
whakakikī	whakakikītia
whakakino	whakakinotia
whakakite	whakakitea
whakakoi	whakakoia
whakakopakopa	whakakopakopaia
whakakōpeke	whakakōpeketia
whakakopi	whakakopitia
whakakore	whakakoretia
whakakorokoro	whakakorokorotia
whakakoromeke	whakakoromeketia
whakakōrua	whakakōruatia
whakamahana	whakamahanatia
whakamahara	whakamaharatia
whakamahi	whakamahia
whakamākūkū	whakamākūkūtia
whakamāmā	whakamāmātia
whakamamae	whakamamaetia
whakamana	whakamanahia
whakamanawa	whakamanawatia
whakamānu	whakamānutia
whakamāoa	whakamāoatia
whakamāori	whakamāoritia
whakamārama	whakamāramatia
whakamārie	whakamārietia
whakamaroke	whakamaroketia
whakamārōrō	whakamārōrōtia
whakamataku	whakamatakuria
whakamātaotao	whakamātaotaoria
whakamātau	whakamātauria
whakamātautau	whakamātautauria
whakamate	whakamatea
whakamau	whakamaua
whakamihi	whakamihia
whakamīharo	whakamīharotia
whakamine	whakaminea
whakamoe	whakamoea
whakamōhio	whakamōhiotia
whakamōkā	whakamōkātia
whakamuri	whakamuria
whakamutu	whakamutua
whakananu	whakananua
whakangaere	whakangaerea
whakangahau	whakangahautia
whakangahoro	whakangahorotia
whakangaro	whakangaromia
whakangau	whakangaua
whakangāwari	whakangāwarihia
whakanoa	whakanoatia
whakanoho	whakanohoia
whakanui	whakanuia
whakaoho	whakaohotia
whakaora	whakaorangia
whakaoti	whakaotihia
whakapā	whakapākia
whakapae	whakapaea
whakapai	whakapaia
whakapaipai	whakapaipaitia
whakapakeke	whakapakeketia
whakapakoko	whakapakokotia
whakapapa	whakapapatia
whakaparahako	whakaparahakotia
whakaparu	whakaparua
whakapau	whakapaungia
whakapiata	whakapiatatia
whakapiko	whakapikoa
whakapiri	whakapiria
whakapōhēhē	whakapōhēhēngia
whakapokorua	whakapokoruatia
whakapono	whakaponohia
whakapoto	whakapotohia
whakapua	whakapuatia
whakapuaki	whakapuakina
whakapuare	whakapuaretia
whakapuhari	whakapuharia
whakapuhi	whakapuhia
whakapūmau	whakapūmautia
whakapuru	whakapurua
whakaputa	whakaputaina
whakarangatira	whakarangatiratia
whakaranu	whakaranua
whakarapa	whakarapangia
whakarapihi	whakarapihitia
whakarāpopoto	whakarāpopotongia
whakarārangi	whakarārangitia
whakararu	whakararua
whakarato	whakaratohia
whakarawa	whakarawatia
whakarāwai	whakarāwaitia
whakarawe	whakarawea
whakareka	whakarekangia
whakarere	whakarerea
whakareri	whakareria
whakarewa	whakarewaia
whakaririki	whakaririkitia
whakariro	whakariroia
whakarite	whakaritea
whakaroa	whakaroatia
whakarongo	whakarongohia
whakataetae	whakataetaengia
whakatahe	whakatahea
whakatahuri	whakatahuringia
whakatairanga	whakatairangatia
whakatākaro	whakatākarotia
whakataki	whakatakina
whakatakitaki	whakatakitakina
whakatakoto	whakatakotoria
whakatākotokoto	whakatākotokotoria
whakatangitangi	whakatangitangihia
whakatanuku	whakatanukutia
whakatapu	whakatapuria
whakatara	whakataraa
whakataratara	whakataratarahia
whakatata	whakatatangia
whakatau	whakatauria
whakataurite	whakatauritea
whakatika	whakatikaia
whakatikatika	whakatikatikaina
whakatīmata	whakatīmatangia
whakatina	whakatinaia
whakatipu	whakatipuria
whakatiraha	whakatirahatia
whakatō	whakatōkia
whakatoi	whakatoitia
whakatōpū	whakatōpūtia
whakatū	whakatūria
whakatūpato	whakatūpatoria
whakatupu	whakatupuria
whakatūtehu	whakatūtehutia
whakatuwhera	whakatuwheratia
whakaū	whakaūngia
whakauru	whakaurua
whakaurunga	whakaurungatia
whakautu	whakautua
whakawā	whakawākia
whakawahi	whakawahia
whakawai	whakawaia
whakawaireka	whakawairekatia
whakaware	whakawarea
whakawātea	whakawāteatia
whakawāwā	whakawāwātia
whakawehi	whakawehia
whakawhāiti	whakawhāititia
whakawhānau	whakawhānautia
whakawherū	whakawherūtia
whakawhirinaki	whakawhirinakitia
whakawhiti	whakawhitia
whakawhiu	whakawhiua
whakawhiwhi	whakawhiwhia
whakawiri	whakawiria
whana	whanaa
whanowhano	whanowhanoa
whānui	whānuitia
whao	whaoa
whata	whataa
whati	whatiia
whatiwhati	whatiwhatia
whatu	whaturia
whāwhā	whāwhāria
whawhai	whawhaitia
whāwhāi	whāwhāitia
whērā	whērātia
wheo	wheotia
whera	wherahia
where	wherea
whetūrangi	whetūrangitia
whiri	whiria
whiriwhiri	whiriwhiria
whiti	whitia
whītiki	whītikiria
whiu	whiua
