ā	[]
ahu	['voiceless, glottal, oral, fricative']
ahuahu	['voiceless, glottal, oral, fricative', 'voiceless, glottal, oral, fricative']
ai	[]
āki	['voiceless, velar, oral, stop']
akiaki	['voiceless, velar, oral, stop', 'voiceless, velar, oral, stop']
ākiri	['voiceless, velar, oral, stop', 'voiced, dental-alveolar, oral, flap']
ākirikiri	['voiceless, velar, oral, stop', 'voiced, dental-alveolar, oral, flap', 'voiceless, velar, oral, stop', 'voiced, dental-alveolar, oral, flap']
ako	['voiceless, velar, oral, stop']
āmi	['voiced, bilabial, nasal, stop']
āmine	['voiced, bilabial, nasal, stop', 'voiced, dental, nasal, stop']
amo	['voiced, bilabial, nasal, stop']
amuamu	['voiced, bilabial, nasal, stop', 'voiced, bilabial, nasal, stop']
ao	[]
apiti	['voiceless, bilabial, oral, stop', 'voiceless, dental, oral, stop']
āpiti	['voiceless, bilabial, oral, stop', 'voiceless, dental, oral, stop']
apo	['voiceless, bilabial, oral, stop']
apoapo	['voiceless, bilabial, oral, stop', 'voiceless, bilabial, oral, stop']
apu	['voiceless, bilabial, oral, stop']
āpuru	['voiceless, bilabial, oral, stop', 'voiced, dental-alveolar, oral, flap']
ara	['voiced, dental-alveolar, oral, flap']
arahi	['voiced, dental-alveolar, oral, flap', 'voiceless, glottal, oral, fricative']
ārahi	['voiced, dental-alveolar, oral, flap', 'voiceless, glottal, oral, fricative']
ārai	['voiced, dental-alveolar, oral, flap']
arataki	['voiced, dental-alveolar, oral, flap', 'voiceless, dental, oral, stop', 'voiceless, velar, oral, stop']
aro	['voiced, dental-alveolar, oral, flap']
aroha	['voiced, dental-alveolar, oral, flap', 'voiceless, glottal, oral, fricative']
aru	['voiced, dental-alveolar, oral, flap']
aruaru	['voiced, dental-alveolar, oral, flap', 'voiced, dental-alveolar, oral, flap']
atawhai	['voiceless, dental, oral, stop', 'voiceless, labio-dental, oral, fricative']
ātete	['voiceless, dental, oral, stop', 'voiceless, dental, oral, stop']
ato	['voiceless, dental, oral, stop']
auē	[]
aukaha	['voiceless, velar, oral, stop', 'voiceless, glottal, oral, fricative']
auru	['voiced, dental-alveolar, oral, flap']
aweke	['voiced, bilabial, oral, approximant', 'voiceless, velar, oral, stop']
awhe	['voiceless, labio-dental, oral, fricative']
awhi	['voiceless, labio-dental, oral, fricative']
awhina	['voiceless, labio-dental, oral, fricative', 'voiced, dental, nasal, stop']
āwhina	['voiceless, labio-dental, oral, fricative', 'voiced, dental, nasal, stop']
āwhio	['voiceless, labio-dental, oral, fricative']
ehu	['voiceless, glottal, oral, fricative']
eke	['voiceless, velar, oral, stop']
epa	['voiceless, bilabial, oral, stop']
whakarārangi	['voiceless, labio-dental, oral, fricative', 'voiceless, velar, oral, stop', 'voiced, dental-alveolar, oral, flap', 'voiced, dental-alveolar, oral, flap', 'voiced, velar, nasal, stop']
haehae	['voiceless, glottal, oral, fricative', 'voiceless, glottal, oral, fricative']
haere	['voiceless, glottal, oral, fricative', 'voiced, dental-alveolar, oral, flap']
hahau	['voiceless, glottal, oral, fricative', 'voiceless, glottal, oral, fricative']
hāhau	['voiceless, glottal, oral, fricative', 'voiceless, glottal, oral, fricative']
hahu	['voiceless, glottal, oral, fricative', 'voiceless, glottal, oral, fricative']
haina	['voiceless, glottal, oral, fricative', 'voiced, dental, nasal, stop']
haka	['voiceless, glottal, oral, fricative', 'voiceless, velar, oral, stop']
hākere	['voiceless, glottal, oral, fricative', 'voiceless, velar, oral, stop', 'voiced, dental-alveolar, oral, flap']
haku	['voiceless, glottal, oral, fricative', 'voiceless, velar, oral, stop']
hakuhaku	['voiceless, glottal, oral, fricative', 'voiceless, velar, oral, stop', 'voiceless, glottal, oral, fricative', 'voiceless, velar, oral, stop']
hāmene	['voiceless, glottal, oral, fricative', 'voiced, bilabial, nasal, stop', 'voiced, dental, nasal, stop']
hane	['voiceless, glottal, oral, fricative', 'voiced, dental, nasal, stop']
hanga	['voiceless, glottal, oral, fricative', 'voiced, velar, nasal, stop']
hao	['voiceless, glottal, oral, fricative']
hāpai	['voiceless, glottal, oral, fricative', 'voiceless, bilabial, oral, stop']
hari	['voiceless, glottal, oral, fricative', 'voiced, dental-alveolar, oral, flap']
hauhake	['voiceless, glottal, oral, fricative', 'voiceless, glottal, oral, fricative', 'voiceless, velar, oral, stop']
haupapa	['voiceless, glottal, oral, fricative', 'voiceless, bilabial, oral, stop', 'voiceless, bilabial, oral, stop']
hāwhe	['voiceless, glottal, oral, fricative', 'voiceless, labio-dental, oral, fricative']
heke	['voiceless, glottal, oral, fricative', 'voiceless, velar, oral, stop']
here	['voiceless, glottal, oral, fricative', 'voiced, dental-alveolar, oral, flap']
herehere	['voiceless, glottal, oral, fricative', 'voiced, dental-alveolar, oral, flap', 'voiceless, glottal, oral, fricative', 'voiced, dental-alveolar, oral, flap']
heru	['voiceless, glottal, oral, fricative', 'voiced, dental-alveolar, oral, flap']
heu	['voiceless, glottal, oral, fricative']
heuheu	['voiceless, glottal, oral, fricative', 'voiceless, glottal, oral, fricative']
hī	['voiceless, glottal, oral, fricative']
hiahia	['voiceless, glottal, oral, fricative', 'voiceless, glottal, oral, fricative']
hīanga	['voiceless, glottal, oral, fricative', 'voiced, velar, nasal, stop']
hihira	['voiceless, glottal, oral, fricative', 'voiceless, glottal, oral, fricative', 'voiced, dental-alveolar, oral, flap']
hihiri	['voiceless, glottal, oral, fricative', 'voiceless, glottal, oral, fricative', 'voiced, dental-alveolar, oral, flap']
hika	['voiceless, glottal, oral, fricative', 'voiceless, velar, oral, stop']
hiki	['voiceless, glottal, oral, fricative', 'voiceless, velar, oral, stop']
hiko	['voiceless, glottal, oral, fricative', 'voiceless, velar, oral, stop']
hinga	['voiceless, glottal, oral, fricative', 'voiced, velar, nasal, stop']
hīpoki	['voiceless, glottal, oral, fricative', 'voiceless, bilabial, oral, stop', 'voiceless, velar, oral, stop']
hīrau	['voiceless, glottal, oral, fricative', 'voiced, dental-alveolar, oral, flap']
hīri	['voiceless, glottal, oral, fricative', 'voiced, dental-alveolar, oral, flap']
hirihiri	['voiceless, glottal, oral, fricative', 'voiced, dental-alveolar, oral, flap', 'voiceless, glottal, oral, fricative', 'voiced, dental-alveolar, oral, flap']
hiwi	['voiceless, glottal, oral, fricative', 'voiced, bilabial, oral, approximant']
hoe	['voiceless, glottal, oral, fricative']
hohou	['voiceless, glottal, oral, fricative', 'voiceless, glottal, oral, fricative']
hoki	['voiceless, glottal, oral, fricative', 'voiceless, velar, oral, stop']
hoko	['voiceless, glottal, oral, fricative', 'voiceless, velar, oral, stop']
hokohoko	['voiceless, glottal, oral, fricative', 'voiceless, velar, oral, stop', 'voiceless, glottal, oral, fricative', 'voiceless, velar, oral, stop']
hokomirimori	['voiceless, glottal, oral, fricative', 'voiceless, velar, oral, stop', 'voiced, bilabial, nasal, stop', 'voiced, dental-alveolar, oral, flap', 'voiced, bilabial, nasal, stop', 'voiced, dental-alveolar, oral, flap']
hongi	['voiceless, glottal, oral, fricative', 'voiced, velar, nasal, stop']
hongihongi	['voiceless, glottal, oral, fricative', 'voiced, velar, nasal, stop', 'voiceless, glottal, oral, fricative', 'voiced, velar, nasal, stop']
hono	['voiceless, glottal, oral, fricative', 'voiced, dental, nasal, stop']
hopu	['voiceless, glottal, oral, fricative', 'voiceless, bilabial, oral, stop']
hora	['voiceless, glottal, oral, fricative', 'voiced, dental-alveolar, oral, flap']
hori	['voiceless, glottal, oral, fricative', 'voiced, dental-alveolar, oral, flap']
horo	['voiceless, glottal, oral, fricative', 'voiced, dental-alveolar, oral, flap']
horo	['voiceless, glottal, oral, fricative', 'voiced, dental-alveolar, oral, flap']
horoi	['voiceless, glottal, oral, fricative', 'voiced, dental-alveolar, oral, flap']
horomi	['voiceless, glottal, oral, fricative', 'voiced, dental-alveolar, oral, flap', 'voiced, bilabial, nasal, stop']
hou	['voiceless, glottal, oral, fricative']
houhou	['voiceless, glottal, oral, fricative', 'voiceless, glottal, oral, fricative']
hua	['voiceless, glottal, oral, fricative']
hua	['voiceless, glottal, oral, fricative']
huaki	['voiceless, glottal, oral, fricative', 'voiceless, velar, oral, stop']
huhu	['voiceless, glottal, oral, fricative', 'voiceless, glottal, oral, fricative']
hui	['voiceless, glottal, oral, fricative']
huihui	['voiceless, glottal, oral, fricative', 'voiceless, glottal, oral, fricative']
huke	['voiceless, glottal, oral, fricative', 'voiceless, velar, oral, stop']
huki	['voiceless, glottal, oral, fricative', 'voiceless, velar, oral, stop']
hukihuki	['voiceless, glottal, oral, fricative', 'voiceless, velar, oral, stop', 'voiceless, glottal, oral, fricative', 'voiceless, velar, oral, stop']
hume	['voiceless, glottal, oral, fricative', 'voiced, bilabial, nasal, stop']
huna	['voiceless, glottal, oral, fricative', 'voiced, dental, nasal, stop']
hunu	['voiceless, glottal, oral, fricative', 'voiced, dental, nasal, stop']
hunuhunu	['voiceless, glottal, oral, fricative', 'voiced, dental, nasal, stop', 'voiceless, glottal, oral, fricative', 'voiced, dental, nasal, stop']
hūpeke	['voiceless, glottal, oral, fricative', 'voiceless, bilabial, oral, stop', 'voiceless, velar, oral, stop']
hura	['voiceless, glottal, oral, fricative', 'voiced, dental-alveolar, oral, flap']
huri	['voiceless, glottal, oral, fricative', 'voiced, dental-alveolar, oral, flap']
huru	['voiceless, glottal, oral, fricative', 'voiced, dental-alveolar, oral, flap']
huti	['voiceless, glottal, oral, fricative', 'voiceless, dental, oral, stop']
iheuheu	['voiceless, glottal, oral, fricative', 'voiceless, glottal, oral, fricative']
ihi	['voiceless, glottal, oral, fricative']
ihiihi	['voiceless, glottal, oral, fricative', 'voiceless, glottal, oral, fricative']
inaki	['voiced, dental, nasal, stop', 'voiceless, velar, oral, stop']
inoi	['voiced, dental, nasal, stop']
inu	['voiced, dental, nasal, stop']
iri	['voiced, dental-alveolar, oral, flap']
kā	['voiceless, velar, oral, stop']
kahaki	['voiceless, velar, oral, stop', 'voiceless, glottal, oral, fricative', 'voiceless, velar, oral, stop']
kāhaki	['voiceless, velar, oral, stop', 'voiceless, glottal, oral, fricative', 'voiceless, velar, oral, stop']
kai	['voiceless, velar, oral, stop']
kaingākau	['voiceless, velar, oral, stop', 'voiced, velar, nasal, stop', 'voiceless, velar, oral, stop']
kaiponu	['voiceless, velar, oral, stop', 'voiceless, bilabial, oral, stop', 'voiced, dental, nasal, stop']
kākahu	['voiceless, velar, oral, stop', 'voiceless, velar, oral, stop', 'voiceless, glottal, oral, fricative']
kakaro	['voiceless, velar, oral, stop', 'voiceless, velar, oral, stop', 'voiced, dental-alveolar, oral, flap']
kakau	['voiceless, velar, oral, stop', 'voiceless, velar, oral, stop']
kake	['voiceless, velar, oral, stop', 'voiceless, velar, oral, stop']
kanga	['voiceless, velar, oral, stop', 'voiced, velar, nasal, stop']
kape	['voiceless, velar, oral, stop', 'voiceless, bilabial, oral, stop']
kapi	['voiceless, velar, oral, stop', 'voiceless, bilabial, oral, stop']
kapo	['voiceless, velar, oral, stop', 'voiceless, bilabial, oral, stop']
kāpui	['voiceless, velar, oral, stop', 'voiceless, bilabial, oral, stop']
karakia	['voiceless, velar, oral, stop', 'voiced, dental-alveolar, oral, flap', 'voiceless, velar, oral, stop']
karanga	['voiceless, velar, oral, stop', 'voiced, dental-alveolar, oral, flap', 'voiced, velar, nasal, stop']
karapoti	['voiceless, velar, oral, stop', 'voiced, dental-alveolar, oral, flap', 'voiceless, bilabial, oral, stop', 'voiceless, dental, oral, stop']
karawhiu	['voiceless, velar, oral, stop', 'voiced, dental-alveolar, oral, flap', 'voiceless, labio-dental, oral, fricative']
kare	['voiceless, velar, oral, stop', 'voiced, dental-alveolar, oral, flap']
kari	['voiceless, velar, oral, stop', 'voiced, dental-alveolar, oral, flap']
karo	['voiceless, velar, oral, stop', 'voiced, dental-alveolar, oral, flap']
karo	['voiceless, velar, oral, stop', 'voiced, dental-alveolar, oral, flap']
kata	['voiceless, velar, oral, stop', 'voiceless, dental, oral, stop']
kati	['voiceless, velar, oral, stop', 'voiceless, dental, oral, stop']
kato	['voiceless, velar, oral, stop', 'voiceless, dental, oral, stop']
kau	['voiceless, velar, oral, stop']
kauhoe	['voiceless, velar, oral, stop', 'voiceless, glottal, oral, fricative']
kaui	['voiceless, velar, oral, stop']
kaukau	['voiceless, velar, oral, stop', 'voiceless, velar, oral, stop']
kaumātua	['voiceless, velar, oral, stop', 'voiced, bilabial, nasal, stop', 'voiceless, dental, oral, stop']
kaupare	['voiceless, velar, oral, stop', 'voiceless, bilabial, oral, stop', 'voiced, dental-alveolar, oral, flap']
kauwhau	['voiceless, velar, oral, stop', 'voiceless, labio-dental, oral, fricative']
kawe	['voiceless, velar, oral, stop', 'voiced, bilabial, oral, approximant']
kāwhaki	['voiceless, velar, oral, stop', 'voiceless, labio-dental, oral, fricative', 'voiceless, velar, oral, stop']
kāwiri	['voiceless, velar, oral, stop', 'voiced, bilabial, oral, approximant', 'voiced, dental-alveolar, oral, flap']
keri	['voiceless, velar, oral, stop', 'voiced, dental-alveolar, oral, flap']
ketu	['voiceless, velar, oral, stop', 'voiceless, dental, oral, stop']
ketuketu	['voiceless, velar, oral, stop', 'voiceless, dental, oral, stop', 'voiceless, velar, oral, stop', 'voiceless, dental, oral, stop']
keu	['voiceless, velar, oral, stop']
kī	['voiceless, velar, oral, stop']
kihi	['voiceless, velar, oral, stop', 'voiceless, glottal, oral, fricative']
kiki	['voiceless, velar, oral, stop', 'voiceless, velar, oral, stop']
kikini	['voiceless, velar, oral, stop', 'voiceless, velar, oral, stop', 'voiced, dental, nasal, stop']
kimi	['voiceless, velar, oral, stop', 'voiced, bilabial, nasal, stop']
kini	['voiceless, velar, oral, stop', 'voiced, dental, nasal, stop']
kite	['voiceless, velar, oral, stop', 'voiceless, dental, oral, stop']
ko	['voiceless, velar, oral, stop']
kō	['voiceless, velar, oral, stop']
koa	['voiceless, velar, oral, stop']
koara	['voiceless, velar, oral, stop', 'voiced, dental-alveolar, oral, flap']
kōhari	['voiceless, velar, oral, stop', 'voiceless, glottal, oral, fricative', 'voiced, dental-alveolar, oral, flap']
kohi	['voiceless, velar, oral, stop', 'voiceless, glottal, oral, fricative']
kohikohi	['voiceless, velar, oral, stop', 'voiceless, glottal, oral, fricative', 'voiceless, velar, oral, stop', 'voiceless, glottal, oral, fricative']
kōhua	['voiceless, velar, oral, stop', 'voiceless, glottal, oral, fricative']
kōhue	['voiceless, velar, oral, stop', 'voiceless, glottal, oral, fricative']
kōhure	['voiceless, velar, oral, stop', 'voiceless, glottal, oral, fricative', 'voiced, dental-alveolar, oral, flap']
kōhuru	['voiceless, velar, oral, stop', 'voiceless, glottal, oral, fricative', 'voiced, dental-alveolar, oral, flap']
koingo	['voiceless, velar, oral, stop', 'voiced, velar, nasal, stop']
kōkiri	['voiceless, velar, oral, stop', 'voiceless, velar, oral, stop', 'voiced, dental-alveolar, oral, flap']
koko	['voiceless, velar, oral, stop', 'voiceless, velar, oral, stop']
kōmiri	['voiceless, velar, oral, stop', 'voiced, bilabial, nasal, stop', 'voiced, dental-alveolar, oral, flap']
komo	['voiceless, velar, oral, stop', 'voiced, bilabial, nasal, stop']
komutu	['voiceless, velar, oral, stop', 'voiced, bilabial, nasal, stop', 'voiceless, dental, oral, stop']
kōnatu	['voiceless, velar, oral, stop', 'voiced, dental, nasal, stop', 'voiceless, dental, oral, stop']
kōpake	['voiceless, velar, oral, stop', 'voiceless, bilabial, oral, stop', 'voiceless, velar, oral, stop']
kōpaki	['voiceless, velar, oral, stop', 'voiceless, bilabial, oral, stop', 'voiceless, velar, oral, stop']
kopani	['voiceless, velar, oral, stop', 'voiceless, bilabial, oral, stop', 'voiced, dental, nasal, stop']
kōpani	['voiceless, velar, oral, stop', 'voiceless, bilabial, oral, stop', 'voiced, dental, nasal, stop']
kōpare	['voiceless, velar, oral, stop', 'voiceless, bilabial, oral, stop', 'voiced, dental-alveolar, oral, flap']
kōpenu	['voiceless, velar, oral, stop', 'voiceless, bilabial, oral, stop', 'voiced, dental, nasal, stop']
kōpenupenu	['voiceless, velar, oral, stop', 'voiceless, bilabial, oral, stop', 'voiced, dental, nasal, stop', 'voiceless, bilabial, oral, stop', 'voiced, dental, nasal, stop']
kopi	['voiceless, velar, oral, stop', 'voiceless, bilabial, oral, stop']
kōpiro	['voiceless, velar, oral, stop', 'voiceless, bilabial, oral, stop', 'voiced, dental-alveolar, oral, flap']
kōranga	['voiceless, velar, oral, stop', 'voiced, dental-alveolar, oral, flap', 'voiced, velar, nasal, stop']
kōrero	['voiceless, velar, oral, stop', 'voiced, dental-alveolar, oral, flap', 'voiced, dental-alveolar, oral, flap']
koro	['voiceless, velar, oral, stop', 'voiced, dental-alveolar, oral, flap']
kōrori	['voiceless, velar, oral, stop', 'voiced, dental-alveolar, oral, flap', 'voiced, dental-alveolar, oral, flap']
korou	['voiceless, velar, oral, stop', 'voiced, dental-alveolar, oral, flap']
kote	['voiceless, velar, oral, stop', 'voiceless, dental, oral, stop']
kōti	['voiceless, velar, oral, stop', 'voiceless, dental, oral, stop']
kōtui	['voiceless, velar, oral, stop', 'voiceless, dental, oral, stop']
kowhaki	['voiceless, velar, oral, stop', 'voiceless, labio-dental, oral, fricative', 'voiceless, velar, oral, stop']
kowhete	['voiceless, velar, oral, stop', 'voiceless, labio-dental, oral, fricative', 'voiceless, dental, oral, stop']
kōwhiri	['voiceless, velar, oral, stop', 'voiceless, labio-dental, oral, fricative', 'voiced, dental-alveolar, oral, flap']
kōwhiti	['voiceless, velar, oral, stop', 'voiceless, labio-dental, oral, fricative', 'voiceless, dental, oral, stop']
kuhu	['voiceless, velar, oral, stop', 'voiceless, glottal, oral, fricative']
kuku	['voiceless, velar, oral, stop', 'voiceless, velar, oral, stop']
kume	['voiceless, velar, oral, stop', 'voiced, bilabial, nasal, stop']
kumu	['voiceless, velar, oral, stop', 'voiced, bilabial, nasal, stop']
kuru	['voiceless, velar, oral, stop', 'voiced, dental-alveolar, oral, flap']
kuti	['voiceless, velar, oral, stop', 'voiceless, dental, oral, stop']
mahanga	['voiced, bilabial, nasal, stop', 'voiceless, glottal, oral, fricative', 'voiced, velar, nasal, stop']
mahara	['voiced, bilabial, nasal, stop', 'voiceless, glottal, oral, fricative', 'voiced, dental-alveolar, oral, flap']
māharahara	['voiced, bilabial, nasal, stop', 'voiceless, glottal, oral, fricative', 'voiced, dental-alveolar, oral, flap', 'voiceless, glottal, oral, fricative', 'voiced, dental-alveolar, oral, flap']
mahi	['voiced, bilabial, nasal, stop', 'voiceless, glottal, oral, fricative']
mahimahi	['voiced, bilabial, nasal, stop', 'voiceless, glottal, oral, fricative', 'voiced, bilabial, nasal, stop', 'voiceless, glottal, oral, fricative']
maka	['voiced, bilabial, nasal, stop', 'voiceless, velar, oral, stop']
mākiri	['voiced, bilabial, nasal, stop', 'voiceless, velar, oral, stop', 'voiced, dental-alveolar, oral, flap']
mākutu	['voiced, bilabial, nasal, stop', 'voiceless, velar, oral, stop', 'voiceless, dental, oral, stop']
maminga	['voiced, bilabial, nasal, stop', 'voiced, bilabial, nasal, stop', 'voiced, velar, nasal, stop']
manaaki	['voiced, bilabial, nasal, stop', 'voiced, dental, nasal, stop', 'voiceless, velar, oral, stop']
manako	['voiced, bilabial, nasal, stop', 'voiced, dental, nasal, stop', 'voiceless, velar, oral, stop']
mania	['voiced, bilabial, nasal, stop', 'voiced, dental, nasal, stop']
mapu	['voiced, bilabial, nasal, stop', 'voiceless, bilabial, oral, stop']
mārau	['voiced, bilabial, nasal, stop', 'voiced, dental-alveolar, oral, flap']
mārena	['voiced, bilabial, nasal, stop', 'voiced, dental-alveolar, oral, flap', 'voiced, dental, nasal, stop']
maro	['voiced, bilabial, nasal, stop', 'voiced, dental-alveolar, oral, flap']
mātaki	['voiced, bilabial, nasal, stop', 'voiceless, dental, oral, stop', 'voiceless, velar, oral, stop']
mātakitaki	['voiced, bilabial, nasal, stop', 'voiceless, dental, oral, stop', 'voiceless, velar, oral, stop', 'voiceless, dental, oral, stop', 'voiceless, velar, oral, stop']
mātau	['voiced, bilabial, nasal, stop', 'voiceless, dental, oral, stop']
mātau	['voiced, bilabial, nasal, stop', 'voiceless, dental, oral, stop']
mate	['voiced, bilabial, nasal, stop', 'voiceless, dental, oral, stop']
mau	['voiced, bilabial, nasal, stop']
māunu	['voiced, bilabial, nasal, stop', 'voiced, dental, nasal, stop']
mea	['voiced, bilabial, nasal, stop']
meke	['voiced, bilabial, nasal, stop', 'voiceless, velar, oral, stop']
mekemeke	['voiced, bilabial, nasal, stop', 'voiceless, velar, oral, stop', 'voiced, bilabial, nasal, stop', 'voiceless, velar, oral, stop']
memeke	['voiced, bilabial, nasal, stop', 'voiced, bilabial, nasal, stop', 'voiceless, velar, oral, stop']
mīharo	['voiced, bilabial, nasal, stop', 'voiceless, glottal, oral, fricative', 'voiced, dental-alveolar, oral, flap']
mihi	['voiced, bilabial, nasal, stop', 'voiceless, glottal, oral, fricative']
minita	['voiced, bilabial, nasal, stop', 'voiced, dental, nasal, stop', 'voiceless, dental, oral, stop']
miraka	['voiced, bilabial, nasal, stop', 'voiced, dental-alveolar, oral, flap', 'voiceless, velar, oral, stop']
miri	['voiced, bilabial, nasal, stop', 'voiced, dental-alveolar, oral, flap']
miro	['voiced, bilabial, nasal, stop', 'voiced, dental-alveolar, oral, flap']
miti	['voiced, bilabial, nasal, stop', 'voiceless, dental, oral, stop']
mitimiti	['voiced, bilabial, nasal, stop', 'voiceless, dental, oral, stop', 'voiced, bilabial, nasal, stop', 'voiceless, dental, oral, stop']
moe	['voiced, bilabial, nasal, stop']
mōhio	['voiced, bilabial, nasal, stop', 'voiceless, glottal, oral, fricative']
mōkete	['voiced, bilabial, nasal, stop', 'voiceless, velar, oral, stop', 'voiceless, dental, oral, stop']
momi	['voiced, bilabial, nasal, stop', 'voiced, bilabial, nasal, stop']
mono	['voiced, bilabial, nasal, stop', 'voiced, dental, nasal, stop']
moto	['voiced, bilabial, nasal, stop', 'voiceless, dental, oral, stop']
motu	['voiced, bilabial, nasal, stop', 'voiceless, dental, oral, stop']
mōunu	['voiced, bilabial, nasal, stop', 'voiced, dental, nasal, stop']
mui	['voiced, bilabial, nasal, stop']
muimui	['voiced, bilabial, nasal, stop', 'voiced, bilabial, nasal, stop']
muku	['voiced, bilabial, nasal, stop', 'voiceless, velar, oral, stop']
mukumuku	['voiced, bilabial, nasal, stop', 'voiceless, velar, oral, stop', 'voiced, bilabial, nasal, stop', 'voiceless, velar, oral, stop']
muna	['voiced, bilabial, nasal, stop', 'voiced, dental, nasal, stop']
muru	['voiced, bilabial, nasal, stop', 'voiced, dental-alveolar, oral, flap']
mutumutu	['voiced, bilabial, nasal, stop', 'voiceless, dental, oral, stop', 'voiced, bilabial, nasal, stop', 'voiceless, dental, oral, stop']
nanao	['voiced, dental, nasal, stop', 'voiced, dental, nasal, stop']
nao	['voiced, dental, nasal, stop']
narunga	['voiced, dental, nasal, stop', 'voiced, dental-alveolar, oral, flap', 'voiced, velar, nasal, stop']
nati	['voiced, dental, nasal, stop', 'voiceless, dental, oral, stop']
natu	['voiced, dental, nasal, stop', 'voiceless, dental, oral, stop']
nēhi	['voiced, dental, nasal, stop', 'voiceless, glottal, oral, fricative']
nehu	['voiced, dental, nasal, stop', 'voiceless, glottal, oral, fricative']
neke	['voiced, dental, nasal, stop', 'voiceless, velar, oral, stop']
nekeneke	['voiced, dental, nasal, stop', 'voiceless, velar, oral, stop', 'voiced, dental, nasal, stop', 'voiceless, velar, oral, stop']
ngahu	['voiced, velar, nasal, stop', 'voiceless, glottal, oral, fricative']
ngaki	['voiced, velar, nasal, stop', 'voiceless, velar, oral, stop']
ngare	['voiced, velar, nasal, stop', 'voiced, dental-alveolar, oral, flap']
ngau	['voiced, velar, nasal, stop']
ngaungau	['voiced, velar, nasal, stop', 'voiced, velar, nasal, stop']
ngote	['voiced, velar, nasal, stop', 'voiceless, dental, oral, stop']
niko	['voiced, dental, nasal, stop', 'voiceless, velar, oral, stop']
noa	['voiced, dental, nasal, stop']
noho	['voiced, dental, nasal, stop', 'voiceless, glottal, oral, fricative']
nuka	['voiced, dental, nasal, stop', 'voiceless, velar, oral, stop']
nukarau	['voiced, dental, nasal, stop', 'voiceless, velar, oral, stop', 'voiced, dental-alveolar, oral, flap']
nuku	['voiced, dental, nasal, stop', 'voiceless, velar, oral, stop']
nukunuku	['voiced, dental, nasal, stop', 'voiceless, velar, oral, stop', 'voiced, dental, nasal, stop', 'voiceless, velar, oral, stop']
numi	['voiced, dental, nasal, stop', 'voiced, bilabial, nasal, stop']
numu	['voiced, dental, nasal, stop', 'voiced, bilabial, nasal, stop']
oati	['voiceless, dental, oral, stop']
oka	['voiceless, velar, oral, stop']
oke	['voiceless, velar, oral, stop']
oma	['voiced, bilabial, nasal, stop']
onioni	['voiced, dental, nasal, stop', 'voiced, dental, nasal, stop']
ono	['voiced, dental, nasal, stop']
opa	['voiceless, bilabial, oral, stop']
ore	['voiced, dental-alveolar, oral, flap']
oro	['voiced, dental-alveolar, oral, flap']
ota	['voiceless, dental, oral, stop']
pā	['voiceless, bilabial, oral, stop']
pae	['voiceless, bilabial, oral, stop']
pāera	['voiceless, bilabial, oral, stop', 'voiced, dental-alveolar, oral, flap']
pāhua	['voiceless, bilabial, oral, stop', 'voiceless, glottal, oral, fricative']
pai	['voiceless, bilabial, oral, stop']
paihere	['voiceless, bilabial, oral, stop', 'voiceless, glottal, oral, fricative', 'voiced, dental-alveolar, oral, flap']
paikarāihe	['voiceless, bilabial, oral, stop', 'voiceless, velar, oral, stop', 'voiced, dental-alveolar, oral, flap', 'voiceless, glottal, oral, fricative']
pāike	['voiceless, bilabial, oral, stop', 'voiceless, velar, oral, stop']
paka	['voiceless, bilabial, oral, stop', 'voiceless, velar, oral, stop']
pakanga	['voiceless, bilabial, oral, stop', 'voiceless, velar, oral, stop', 'voiced, velar, nasal, stop']
pākaru	['voiceless, bilabial, oral, stop', 'voiceless, velar, oral, stop', 'voiced, dental-alveolar, oral, flap']
pākarukaru	['voiceless, bilabial, oral, stop', 'voiceless, velar, oral, stop', 'voiced, dental-alveolar, oral, flap', 'voiceless, velar, oral, stop', 'voiced, dental-alveolar, oral, flap']
pākawe	['voiceless, bilabial, oral, stop', 'voiceless, velar, oral, stop', 'voiced, bilabial, oral, approximant']
pana	['voiceless, bilabial, oral, stop', 'voiced, dental, nasal, stop']
panga	['voiceless, bilabial, oral, stop', 'voiced, velar, nasal, stop']
pani	['voiceless, bilabial, oral, stop', 'voiced, dental, nasal, stop']
panipani	['voiceless, bilabial, oral, stop', 'voiced, dental, nasal, stop', 'voiceless, bilabial, oral, stop', 'voiced, dental, nasal, stop']
pānui	['voiceless, bilabial, oral, stop', 'voiced, dental, nasal, stop']
pao	['voiceless, bilabial, oral, stop']
paora	['voiceless, bilabial, oral, stop', 'voiced, dental-alveolar, oral, flap']
paoro	['voiceless, bilabial, oral, stop', 'voiced, dental-alveolar, oral, flap']
parai	['voiceless, bilabial, oral, stop', 'voiced, dental-alveolar, oral, flap']
parakitihi	['voiceless, bilabial, oral, stop', 'voiced, dental-alveolar, oral, flap', 'voiceless, velar, oral, stop', 'voiceless, dental, oral, stop', 'voiceless, glottal, oral, fricative']
parani	['voiceless, bilabial, oral, stop', 'voiced, dental-alveolar, oral, flap', 'voiced, dental, nasal, stop']
parau	['voiceless, bilabial, oral, stop', 'voiced, dental-alveolar, oral, flap']
pare	['voiceless, bilabial, oral, stop', 'voiced, dental-alveolar, oral, flap']
paro	['voiceless, bilabial, oral, stop', 'voiced, dental-alveolar, oral, flap']
pātai	['voiceless, bilabial, oral, stop', 'voiceless, dental, oral, stop']
pati	['voiceless, bilabial, oral, stop', 'voiceless, dental, oral, stop']
patō	['voiceless, bilabial, oral, stop', 'voiceless, dental, oral, stop']
patu	['voiceless, bilabial, oral, stop', 'voiceless, dental, oral, stop']
pauna	['voiceless, bilabial, oral, stop', 'voiced, dental, nasal, stop']
pāuna	['voiceless, bilabial, oral, stop', 'voiced, dental, nasal, stop']
paura	['voiceless, bilabial, oral, stop', 'voiced, dental-alveolar, oral, flap']
pāwhara	['voiceless, bilabial, oral, stop', 'voiceless, labio-dental, oral, fricative', 'voiced, dental-alveolar, oral, flap']
pēhea	['voiceless, bilabial, oral, stop', 'voiceless, glottal, oral, fricative']
pēhi	['voiceless, bilabial, oral, stop', 'voiceless, glottal, oral, fricative']
pehipehi	['voiceless, bilabial, oral, stop', 'voiceless, glottal, oral, fricative', 'voiceless, bilabial, oral, stop', 'voiceless, glottal, oral, fricative']
pei	['voiceless, bilabial, oral, stop']
peka	['voiceless, bilabial, oral, stop', 'voiceless, velar, oral, stop']
pēke	['voiceless, bilabial, oral, stop', 'voiceless, velar, oral, stop']
pēnā	['voiceless, bilabial, oral, stop', 'voiced, dental, nasal, stop']
pēnei	['voiceless, bilabial, oral, stop', 'voiced, dental, nasal, stop']
pērā	['voiceless, bilabial, oral, stop', 'voiced, dental-alveolar, oral, flap']
pere	['voiceless, bilabial, oral, stop', 'voiced, dental-alveolar, oral, flap']
perehi	['voiceless, bilabial, oral, stop', 'voiced, dental-alveolar, oral, flap', 'voiceless, glottal, oral, fricative']
pīangi	['voiceless, bilabial, oral, stop', 'voiced, velar, nasal, stop']
pīkau	['voiceless, bilabial, oral, stop', 'voiceless, velar, oral, stop']
piki	['voiceless, bilabial, oral, stop', 'voiceless, velar, oral, stop']
piko	['voiceless, bilabial, oral, stop', 'voiceless, velar, oral, stop']
pine	['voiceless, bilabial, oral, stop', 'voiced, dental, nasal, stop']
pīnohi	['voiceless, bilabial, oral, stop', 'voiced, dental, nasal, stop', 'voiceless, glottal, oral, fricative']
pīoi	['voiceless, bilabial, oral, stop']
piro	['voiceless, bilabial, oral, stop', 'voiced, dental-alveolar, oral, flap']
piu	['voiceless, bilabial, oral, stop']
piupiu	['voiceless, bilabial, oral, stop', 'voiceless, bilabial, oral, stop']
pō	['voiceless, bilabial, oral, stop']
pōhēhē	['voiceless, bilabial, oral, stop', 'voiceless, glottal, oral, fricative', 'voiceless, glottal, oral, fricative']
pōhiri	['voiceless, bilabial, oral, stop', 'voiceless, glottal, oral, fricative', 'voiced, dental-alveolar, oral, flap']
poipoi	['voiceless, bilabial, oral, stop', 'voiceless, bilabial, oral, stop']
poka	['voiceless, bilabial, oral, stop', 'voiceless, velar, oral, stop']
pōkai	['voiceless, bilabial, oral, stop', 'voiceless, velar, oral, stop']
poke	['voiceless, bilabial, oral, stop', 'voiceless, velar, oral, stop']
pokuru	['voiceless, bilabial, oral, stop', 'voiceless, velar, oral, stop', 'voiced, dental-alveolar, oral, flap']
pona	['voiceless, bilabial, oral, stop', 'voiced, dental, nasal, stop']
popo	['voiceless, bilabial, oral, stop', 'voiceless, bilabial, oral, stop']
pōpopo	['voiceless, bilabial, oral, stop', 'voiceless, bilabial, oral, stop', 'voiceless, bilabial, oral, stop']
pōrangi	['voiceless, bilabial, oral, stop', 'voiced, dental-alveolar, oral, flap', 'voiced, velar, nasal, stop']
poro	['voiceless, bilabial, oral, stop', 'voiced, dental-alveolar, oral, flap']
poroporo	['voiceless, bilabial, oral, stop', 'voiced, dental-alveolar, oral, flap', 'voiceless, bilabial, oral, stop', 'voiced, dental-alveolar, oral, flap']
pororua	['voiceless, bilabial, oral, stop', 'voiced, dental-alveolar, oral, flap', 'voiced, dental-alveolar, oral, flap']
porowhiu	['voiceless, bilabial, oral, stop', 'voiced, dental-alveolar, oral, flap', 'voiceless, labio-dental, oral, fricative']
pōtae	['voiceless, bilabial, oral, stop', 'voiceless, dental, oral, stop']
pōti	['voiceless, bilabial, oral, stop', 'voiceless, dental, oral, stop']
pou	['voiceless, bilabial, oral, stop']
pōuto	['voiceless, bilabial, oral, stop', 'voiceless, dental, oral, stop']
pōwhiri	['voiceless, bilabial, oral, stop', 'voiceless, labio-dental, oral, fricative', 'voiced, dental-alveolar, oral, flap']
pū	['voiceless, bilabial, oral, stop']
puare	['voiceless, bilabial, oral, stop', 'voiced, dental-alveolar, oral, flap']
pūāwai	['voiceless, bilabial, oral, stop', 'voiced, bilabial, oral, approximant']
pūawhe	['voiceless, bilabial, oral, stop', 'voiceless, labio-dental, oral, fricative']
puhi	['voiceless, bilabial, oral, stop', 'voiceless, glottal, oral, fricative']
pūkai	['voiceless, bilabial, oral, stop', 'voiceless, velar, oral, stop']
punga	['voiceless, bilabial, oral, stop', 'voiced, velar, nasal, stop']
pūranga	['voiceless, bilabial, oral, stop', 'voiced, dental-alveolar, oral, flap', 'voiced, velar, nasal, stop']
purei	['voiceless, bilabial, oral, stop', 'voiced, dental-alveolar, oral, flap']
pūremu	['voiceless, bilabial, oral, stop', 'voiced, dental-alveolar, oral, flap', 'voiced, bilabial, nasal, stop']
puri	['voiceless, bilabial, oral, stop', 'voiced, dental-alveolar, oral, flap']
puru	['voiceless, bilabial, oral, stop', 'voiced, dental-alveolar, oral, flap']
puruma	['voiceless, bilabial, oral, stop', 'voiced, dental-alveolar, oral, flap', 'voiced, bilabial, nasal, stop']
purūma	['voiceless, bilabial, oral, stop', 'voiced, dental-alveolar, oral, flap', 'voiced, bilabial, nasal, stop']
purupuru	['voiceless, bilabial, oral, stop', 'voiced, dental-alveolar, oral, flap', 'voiceless, bilabial, oral, stop', 'voiced, dental-alveolar, oral, flap']
puta	['voiceless, bilabial, oral, stop', 'voiceless, dental, oral, stop']
raho	['voiced, dental-alveolar, oral, flap', 'voiceless, glottal, oral, fricative']
rahoraho	['voiced, dental-alveolar, oral, flap', 'voiceless, glottal, oral, fricative', 'voiced, dental-alveolar, oral, flap', 'voiceless, glottal, oral, fricative']
rahu	['voiced, dental-alveolar, oral, flap', 'voiceless, glottal, oral, fricative']
rāhui	['voiced, dental-alveolar, oral, flap', 'voiceless, glottal, oral, fricative']
raka	['voiced, dental-alveolar, oral, flap', 'voiceless, velar, oral, stop']
rākei	['voiced, dental-alveolar, oral, flap', 'voiceless, velar, oral, stop']
rama	['voiced, dental-alveolar, oral, flap', 'voiced, bilabial, nasal, stop']
ranga	['voiced, dental-alveolar, oral, flap', 'voiced, velar, nasal, stop']
rangahau	['voiced, dental-alveolar, oral, flap', 'voiced, velar, nasal, stop', 'voiceless, glottal, oral, fricative']
rangirangi	['voiced, dental-alveolar, oral, flap', 'voiced, velar, nasal, stop', 'voiced, dental-alveolar, oral, flap', 'voiced, velar, nasal, stop']
ranu	['voiced, dental-alveolar, oral, flap', 'voiced, dental, nasal, stop']
rapa	['voiced, dental-alveolar, oral, flap', 'voiceless, bilabial, oral, stop']
rapi	['voiced, dental-alveolar, oral, flap', 'voiceless, bilabial, oral, stop']
rāpoi	['voiced, dental-alveolar, oral, flap', 'voiceless, bilabial, oral, stop']
rapu	['voiced, dental-alveolar, oral, flap', 'voiceless, bilabial, oral, stop']
rara	['voiced, dental-alveolar, oral, flap', 'voiced, dental-alveolar, oral, flap']
rārangi	['voiced, dental-alveolar, oral, flap', 'voiced, dental-alveolar, oral, flap', 'voiced, velar, nasal, stop']
rarapi	['voiced, dental-alveolar, oral, flap', 'voiced, dental-alveolar, oral, flap', 'voiceless, bilabial, oral, stop']
rarawhi	['voiced, dental-alveolar, oral, flap', 'voiced, dental-alveolar, oral, flap', 'voiceless, labio-dental, oral, fricative']
rau	['voiced, dental-alveolar, oral, flap']
raupatu	['voiced, dental-alveolar, oral, flap', 'voiceless, bilabial, oral, stop', 'voiceless, dental, oral, stop']
rautao	['voiced, dental-alveolar, oral, flap', 'voiceless, dental, oral, stop']
raweke	['voiced, dental-alveolar, oral, flap', 'voiced, bilabial, oral, approximant', 'voiceless, velar, oral, stop']
rāwhera	['voiced, dental-alveolar, oral, flap', 'voiceless, labio-dental, oral, fricative', 'voiced, dental-alveolar, oral, flap']
rawhi	['voiced, dental-alveolar, oral, flap', 'voiceless, labio-dental, oral, fricative']
rehe	['voiced, dental-alveolar, oral, flap', 'voiceless, glottal, oral, fricative']
rēhita	['voiced, dental-alveolar, oral, flap', 'voiceless, glottal, oral, fricative', 'voiceless, dental, oral, stop']
rehu	['voiced, dental-alveolar, oral, flap', 'voiceless, glottal, oral, fricative']
rere	['voiced, dental-alveolar, oral, flap', 'voiced, dental-alveolar, oral, flap']
rewherii	['voiced, dental-alveolar, oral, flap', 'voiceless, labio-dental, oral, fricative', 'voiced, dental-alveolar, oral, flap']
rīhi	['voiced, dental-alveolar, oral, flap', 'voiceless, glottal, oral, fricative']
ringi	['voiced, dental-alveolar, oral, flap', 'voiced, velar, nasal, stop']
rīngi	['voiced, dental-alveolar, oral, flap', 'voiced, velar, nasal, stop']
rīpeka	['voiced, dental-alveolar, oral, flap', 'voiceless, bilabial, oral, stop', 'voiceless, velar, oral, stop']
ripi	['voiced, dental-alveolar, oral, flap', 'voiceless, bilabial, oral, stop']
riri	['voiced, dental-alveolar, oral, flap', 'voiced, dental-alveolar, oral, flap']
riringi	['voiced, dental-alveolar, oral, flap', 'voiced, dental-alveolar, oral, flap', 'voiced, velar, nasal, stop']
rohe	['voiced, dental-alveolar, oral, flap', 'voiceless, glottal, oral, fricative']
romi	['voiced, dental-alveolar, oral, flap', 'voiced, bilabial, nasal, stop']
rongo	['voiced, dental-alveolar, oral, flap', 'voiced, velar, nasal, stop']
rongonui	['voiced, dental-alveolar, oral, flap', 'voiced, velar, nasal, stop', 'voiced, dental, nasal, stop']
ropi	['voiced, dental-alveolar, oral, flap', 'voiceless, bilabial, oral, stop']
rore	['voiced, dental-alveolar, oral, flap', 'voiced, dental-alveolar, oral, flap']
rori	['voiced, dental-alveolar, oral, flap', 'voiced, dental-alveolar, oral, flap']
rotu	['voiced, dental-alveolar, oral, flap', 'voiceless, dental, oral, stop']
ruaki	['voiced, dental-alveolar, oral, flap', 'voiceless, velar, oral, stop']
rui	['voiced, dental-alveolar, oral, flap']
ruke	['voiced, dental-alveolar, oral, flap', 'voiceless, velar, oral, stop']
ruku	['voiced, dental-alveolar, oral, flap', 'voiceless, velar, oral, stop']
rumaki	['voiced, dental-alveolar, oral, flap', 'voiced, bilabial, nasal, stop', 'voiceless, velar, oral, stop']
runa	['voiced, dental-alveolar, oral, flap', 'voiced, dental, nasal, stop']
rure	['voiced, dental-alveolar, oral, flap', 'voiced, dental-alveolar, oral, flap']
rurerure	['voiced, dental-alveolar, oral, flap', 'voiced, dental-alveolar, oral, flap', 'voiced, dental-alveolar, oral, flap', 'voiced, dental-alveolar, oral, flap']
rūri	['voiced, dental-alveolar, oral, flap', 'voiced, dental-alveolar, oral, flap']
rūrū	['voiced, dental-alveolar, oral, flap', 'voiced, dental-alveolar, oral, flap']
ruruku	['voiced, dental-alveolar, oral, flap', 'voiced, dental-alveolar, oral, flap', 'voiceless, velar, oral, stop']
rutu	['voiced, dental-alveolar, oral, flap', 'voiceless, dental, oral, stop']
tā	['voiceless, dental, oral, stop']
tae	['voiceless, dental, oral, stop']
tāhae	['voiceless, dental, oral, stop', 'voiceless, glottal, oral, fricative']
tāhawahawa	['voiceless, dental, oral, stop', 'voiceless, glottal, oral, fricative', 'voiced, bilabial, oral, approximant', 'voiceless, glottal, oral, fricative', 'voiced, bilabial, oral, approximant']
tahi	['voiceless, dental, oral, stop', 'voiceless, glottal, oral, fricative']
tahitahi	['voiceless, dental, oral, stop', 'voiceless, glottal, oral, fricative', 'voiceless, dental, oral, stop', 'voiceless, glottal, oral, fricative']
tahu	['voiceless, dental, oral, stop', 'voiceless, glottal, oral, fricative']
taiapo	['voiceless, dental, oral, stop', 'voiceless, bilabial, oral, stop']
taiapu	['voiceless, dental, oral, stop', 'voiceless, bilabial, oral, stop']
taiari	['voiceless, dental, oral, stop', 'voiced, dental-alveolar, oral, flap']
taitai	['voiceless, dental, oral, stop', 'voiceless, dental, oral, stop']
taka	['voiceless, dental, oral, stop', 'voiceless, velar, oral, stop']
takahi	['voiceless, dental, oral, stop', 'voiceless, velar, oral, stop', 'voiceless, glottal, oral, fricative']
takai	['voiceless, dental, oral, stop', 'voiceless, velar, oral, stop']
takakino	['voiceless, dental, oral, stop', 'voiceless, velar, oral, stop', 'voiceless, velar, oral, stop', 'voiced, dental, nasal, stop']
takapapa	['voiceless, dental, oral, stop', 'voiceless, velar, oral, stop', 'voiceless, bilabial, oral, stop', 'voiceless, bilabial, oral, stop']
takapau	['voiceless, dental, oral, stop', 'voiceless, velar, oral, stop', 'voiceless, bilabial, oral, stop']
tākaro	['voiceless, dental, oral, stop', 'voiceless, velar, oral, stop', 'voiced, dental-alveolar, oral, flap']
takawiri	['voiceless, dental, oral, stop', 'voiceless, velar, oral, stop', 'voiced, bilabial, oral, approximant', 'voiced, dental-alveolar, oral, flap']
take	['voiceless, dental, oral, stop', 'voiceless, velar, oral, stop']
tāke	['voiceless, dental, oral, stop', 'voiceless, velar, oral, stop']
taki	['voiceless, dental, oral, stop', 'voiceless, velar, oral, stop']
tākiri	['voiceless, dental, oral, stop', 'voiceless, velar, oral, stop', 'voiced, dental-alveolar, oral, flap']
takitaki	['voiceless, dental, oral, stop', 'voiceless, velar, oral, stop', 'voiceless, dental, oral, stop', 'voiceless, velar, oral, stop']
takoto	['voiceless, dental, oral, stop', 'voiceless, velar, oral, stop', 'voiceless, dental, oral, stop']
tāmaru	['voiceless, dental, oral, stop', 'voiced, bilabial, nasal, stop', 'voiced, dental-alveolar, oral, flap']
tāmau	['voiceless, dental, oral, stop', 'voiced, bilabial, nasal, stop']
tāmi	['voiceless, dental, oral, stop', 'voiced, bilabial, nasal, stop']
tāmuimui	['voiceless, dental, oral, stop', 'voiced, bilabial, nasal, stop', 'voiced, bilabial, nasal, stop']
tamumu	['voiceless, dental, oral, stop', 'voiced, bilabial, nasal, stop', 'voiced, bilabial, nasal, stop']
tānapu	['voiceless, dental, oral, stop', 'voiced, dental, nasal, stop', 'voiceless, bilabial, oral, stop']
tangi	['voiceless, dental, oral, stop', 'voiced, velar, nasal, stop']
tango	['voiceless, dental, oral, stop', 'voiced, velar, nasal, stop']
tanu	['voiceless, dental, oral, stop', 'voiced, dental, nasal, stop']
tānumi	['voiceless, dental, oral, stop', 'voiced, dental, nasal, stop', 'voiced, bilabial, nasal, stop']
tao	['voiceless, dental, oral, stop']
tāoro	['voiceless, dental, oral, stop', 'voiced, dental-alveolar, oral, flap']
tapa	['voiceless, dental, oral, stop', 'voiceless, bilabial, oral, stop']
tāpae	['voiceless, dental, oral, stop', 'voiceless, bilabial, oral, stop']
tapahi	['voiceless, dental, oral, stop', 'voiceless, bilabial, oral, stop', 'voiceless, glottal, oral, fricative']
tāpapa	['voiceless, dental, oral, stop', 'voiceless, bilabial, oral, stop', 'voiceless, bilabial, oral, stop']
tāpāpā	['voiceless, dental, oral, stop', 'voiceless, bilabial, oral, stop', 'voiceless, bilabial, oral, stop']
tapatapa	['voiceless, dental, oral, stop', 'voiceless, bilabial, oral, stop', 'voiceless, dental, oral, stop', 'voiceless, bilabial, oral, stop']
tapatapahi	['voiceless, dental, oral, stop', 'voiceless, bilabial, oral, stop', 'voiceless, dental, oral, stop', 'voiceless, bilabial, oral, stop', 'voiceless, glottal, oral, fricative']
tāpatu	['voiceless, dental, oral, stop', 'voiceless, bilabial, oral, stop', 'voiceless, dental, oral, stop']
tapi	['voiceless, dental, oral, stop', 'voiceless, bilabial, oral, stop']
tāpi	['voiceless, dental, oral, stop', 'voiceless, bilabial, oral, stop']
tapiki	['voiceless, dental, oral, stop', 'voiceless, bilabial, oral, stop', 'voiceless, velar, oral, stop']
tāpiri	['voiceless, dental, oral, stop', 'voiceless, bilabial, oral, stop', 'voiced, dental-alveolar, oral, flap']
tapuhi	['voiceless, dental, oral, stop', 'voiceless, bilabial, oral, stop', 'voiceless, glottal, oral, fricative']
tāpui	['voiceless, dental, oral, stop', 'voiceless, bilabial, oral, stop']
tāpuke	['voiceless, dental, oral, stop', 'voiceless, bilabial, oral, stop', 'voiceless, velar, oral, stop']
tāpuni	['voiceless, dental, oral, stop', 'voiceless, bilabial, oral, stop', 'voiced, dental, nasal, stop']
tarai	['voiceless, dental, oral, stop', 'voiced, dental-alveolar, oral, flap']
tārai	['voiceless, dental, oral, stop', 'voiced, dental-alveolar, oral, flap']
taraiwa	['voiceless, dental, oral, stop', 'voiced, dental-alveolar, oral, flap', 'voiced, bilabial, oral, approximant']
tare	['voiceless, dental, oral, stop', 'voiced, dental-alveolar, oral, flap']
tari	['voiceless, dental, oral, stop', 'voiced, dental-alveolar, oral, flap']
tārona	['voiceless, dental, oral, stop', 'voiced, dental-alveolar, oral, flap', 'voiced, dental, nasal, stop']
tataa	['voiceless, dental, oral, stop', 'voiceless, dental, oral, stop']
tātai	['voiceless, dental, oral, stop', 'voiceless, dental, oral, stop']
tātāmi	['voiceless, dental, oral, stop', 'voiceless, dental, oral, stop', 'voiced, bilabial, nasal, stop']
tātari	['voiceless, dental, oral, stop', 'voiceless, dental, oral, stop', 'voiced, dental-alveolar, oral, flap']
tatau	['voiceless, dental, oral, stop', 'voiceless, dental, oral, stop']
tātāwhi	['voiceless, dental, oral, stop', 'voiceless, dental, oral, stop', 'voiceless, labio-dental, oral, fricative']
tātua	['voiceless, dental, oral, stop', 'voiceless, dental, oral, stop']
tau	['voiceless, dental, oral, stop']
taua	['voiceless, dental, oral, stop']
tauaarai	['voiceless, dental, oral, stop', 'voiced, dental-alveolar, oral, flap']
tauapo	['voiceless, dental, oral, stop', 'voiceless, bilabial, oral, stop']
tauhere	['voiceless, dental, oral, stop', 'voiceless, glottal, oral, fricative', 'voiced, dental-alveolar, oral, flap']
taumau	['voiceless, dental, oral, stop', 'voiced, bilabial, nasal, stop']
taunaha	['voiceless, dental, oral, stop', 'voiced, dental, nasal, stop', 'voiceless, glottal, oral, fricative']
taunga	['voiceless, dental, oral, stop', 'voiced, velar, nasal, stop']
taupare	['voiceless, dental, oral, stop', 'voiceless, bilabial, oral, stop', 'voiced, dental-alveolar, oral, flap']
taupoki	['voiceless, dental, oral, stop', 'voiceless, bilabial, oral, stop', 'voiceless, velar, oral, stop']
tautohe	['voiceless, dental, oral, stop', 'voiceless, dental, oral, stop', 'voiceless, glottal, oral, fricative']
tautohetohe	['voiceless, dental, oral, stop', 'voiceless, dental, oral, stop', 'voiceless, glottal, oral, fricative', 'voiceless, dental, oral, stop', 'voiceless, glottal, oral, fricative']
tautoko	['voiceless, dental, oral, stop', 'voiceless, dental, oral, stop', 'voiceless, velar, oral, stop']
tauwehe	['voiceless, dental, oral, stop', 'voiced, bilabial, oral, approximant', 'voiceless, glottal, oral, fricative']
tāuwhi	['voiceless, dental, oral, stop', 'voiceless, labio-dental, oral, fricative']
tāwai	['voiceless, dental, oral, stop', 'voiced, bilabial, oral, approximant']
tāwharau	['voiceless, dental, oral, stop', 'voiceless, labio-dental, oral, fricative', 'voiced, dental-alveolar, oral, flap']
tāwhi	['voiceless, dental, oral, stop', 'voiceless, labio-dental, oral, fricative']
tāwhio	['voiceless, dental, oral, stop', 'voiceless, labio-dental, oral, fricative']
tāwhiri	['voiceless, dental, oral, stop', 'voiceless, labio-dental, oral, fricative', 'voiced, dental-alveolar, oral, flap']
tāwhiu	['voiceless, dental, oral, stop', 'voiceless, labio-dental, oral, fricative']
tia	['voiceless, dental, oral, stop']
tiaki	['voiceless, dental, oral, stop', 'voiceless, velar, oral, stop']
tīhae	['voiceless, dental, oral, stop', 'voiceless, glottal, oral, fricative']
tīhore	['voiceless, dental, oral, stop', 'voiceless, glottal, oral, fricative', 'voiced, dental-alveolar, oral, flap']
tīkaro	['voiceless, dental, oral, stop', 'voiceless, velar, oral, stop', 'voiced, dental-alveolar, oral, flap']
tiki	['voiceless, dental, oral, stop', 'voiceless, velar, oral, stop']
tīkoko	['voiceless, dental, oral, stop', 'voiceless, velar, oral, stop', 'voiceless, velar, oral, stop']
tīmata	['voiceless, dental, oral, stop', 'voiced, bilabial, nasal, stop', 'voiceless, dental, oral, stop']
timere	['voiceless, dental, oral, stop', 'voiced, bilabial, nasal, stop', 'voiced, dental-alveolar, oral, flap']
tinei	['voiceless, dental, oral, stop', 'voiced, dental, nasal, stop']
tinihanga	['voiceless, dental, oral, stop', 'voiced, dental, nasal, stop', 'voiceless, glottal, oral, fricative', 'voiced, velar, nasal, stop']
tipu	['voiceless, dental, oral, stop', 'voiceless, bilabial, oral, stop']
tiriwa	['voiceless, dental, oral, stop', 'voiced, dental-alveolar, oral, flap', 'voiced, bilabial, oral, approximant']
tiriwaa	['voiceless, dental, oral, stop', 'voiced, dental-alveolar, oral, flap', 'voiced, bilabial, oral, approximant']
tiro	['voiceless, dental, oral, stop', 'voiced, dental-alveolar, oral, flap']
tītama	['voiceless, dental, oral, stop', 'voiceless, dental, oral, stop', 'voiced, bilabial, nasal, stop']
tītari	['voiceless, dental, oral, stop', 'voiceless, dental, oral, stop', 'voiced, dental-alveolar, oral, flap']
titi	['voiceless, dental, oral, stop', 'voiceless, dental, oral, stop']
titoko	['voiceless, dental, oral, stop', 'voiceless, dental, oral, stop', 'voiceless, velar, oral, stop']
tītokotoko	['voiceless, dental, oral, stop', 'voiceless, dental, oral, stop', 'voiceless, velar, oral, stop', 'voiceless, dental, oral, stop', 'voiceless, velar, oral, stop']
tītore	['voiceless, dental, oral, stop', 'voiceless, dental, oral, stop', 'voiced, dental-alveolar, oral, flap']
tiu	['voiceless, dental, oral, stop']
tīwara	['voiceless, dental, oral, stop', 'voiced, bilabial, oral, approximant', 'voiced, dental-alveolar, oral, flap']
tō	['voiceless, dental, oral, stop']
tohatoha	['voiceless, dental, oral, stop', 'voiceless, glottal, oral, fricative', 'voiceless, dental, oral, stop', 'voiceless, glottal, oral, fricative']
tohe	['voiceless, dental, oral, stop', 'voiceless, glottal, oral, fricative']
tohi	['voiceless, dental, oral, stop', 'voiceless, glottal, oral, fricative']
tōhi	['voiceless, dental, oral, stop', 'voiceless, glottal, oral, fricative']
tohu	['voiceless, dental, oral, stop', 'voiceless, glottal, oral, fricative']
tohu	['voiceless, dental, oral, stop', 'voiceless, glottal, oral, fricative']
tōkari	['voiceless, dental, oral, stop', 'voiceless, velar, oral, stop', 'voiced, dental-alveolar, oral, flap']
tokotoko	['voiceless, dental, oral, stop', 'voiceless, velar, oral, stop', 'voiceless, dental, oral, stop', 'voiceless, velar, oral, stop']
tomo	['voiceless, dental, oral, stop', 'voiced, bilabial, nasal, stop']
tono	['voiceless, dental, oral, stop', 'voiced, dental, nasal, stop']
tope	['voiceless, dental, oral, stop', 'voiceless, bilabial, oral, stop']
toro	['voiceless, dental, oral, stop', 'voiced, dental-alveolar, oral, flap']
tou	['voiceless, dental, oral, stop']
toutou	['voiceless, dental, oral, stop', 'voiceless, dental, oral, stop']
tū	['voiceless, dental, oral, stop']
tua	['voiceless, dental, oral, stop']
tūā	['voiceless, dental, oral, stop']
tūahu	['voiceless, dental, oral, stop', 'voiceless, glottal, oral, fricative']
tuaki	['voiceless, dental, oral, stop', 'voiceless, velar, oral, stop']
tuhi	['voiceless, dental, oral, stop', 'voiceless, glottal, oral, fricative']
tuhituhi	['voiceless, dental, oral, stop', 'voiceless, glottal, oral, fricative', 'voiceless, dental, oral, stop', 'voiceless, glottal, oral, fricative']
tūhono	['voiceless, dental, oral, stop', 'voiceless, glottal, oral, fricative', 'voiced, dental, nasal, stop']
tui	['voiceless, dental, oral, stop']
tuitui	['voiceless, dental, oral, stop', 'voiceless, dental, oral, stop']
tuketuke	['voiceless, dental, oral, stop', 'voiceless, velar, oral, stop', 'voiceless, dental, oral, stop', 'voiceless, velar, oral, stop']
tuki	['voiceless, dental, oral, stop', 'voiceless, velar, oral, stop']
tūkino	['voiceless, dental, oral, stop', 'voiceless, velar, oral, stop', 'voiced, dental, nasal, stop']
tuku	['voiceless, dental, oral, stop', 'voiceless, velar, oral, stop']
tukutuku	['voiceless, dental, oral, stop', 'voiceless, velar, oral, stop', 'voiceless, dental, oral, stop', 'voiceless, velar, oral, stop']
tūmanako	['voiceless, dental, oral, stop', 'voiced, bilabial, nasal, stop', 'voiced, dental, nasal, stop', 'voiceless, velar, oral, stop']
tungi	['voiceless, dental, oral, stop', 'voiced, velar, nasal, stop']
tunu	['voiceless, dental, oral, stop', 'voiced, dental, nasal, stop']
tunutunu	['voiceless, dental, oral, stop', 'voiced, dental, nasal, stop', 'voiceless, dental, oral, stop', 'voiced, dental, nasal, stop']
tupehau	['voiceless, dental, oral, stop', 'voiceless, bilabial, oral, stop', 'voiceless, glottal, oral, fricative']
tupeke	['voiceless, dental, oral, stop', 'voiceless, bilabial, oral, stop', 'voiceless, velar, oral, stop']
tūpeke	['voiceless, dental, oral, stop', 'voiceless, bilabial, oral, stop', 'voiceless, velar, oral, stop']
tupoki	['voiceless, dental, oral, stop', 'voiceless, bilabial, oral, stop', 'voiceless, velar, oral, stop']
tupu	['voiceless, dental, oral, stop', 'voiceless, bilabial, oral, stop']
tupua	['voiceless, dental, oral, stop', 'voiceless, bilabial, oral, stop']
turaki	['voiceless, dental, oral, stop', 'voiced, dental-alveolar, oral, flap', 'voiceless, velar, oral, stop']
turuki	['voiceless, dental, oral, stop', 'voiced, dental-alveolar, oral, flap', 'voiceless, velar, oral, stop']
tūtaki	['voiceless, dental, oral, stop', 'voiceless, dental, oral, stop', 'voiceless, velar, oral, stop']
tute	['voiceless, dental, oral, stop', 'voiceless, dental, oral, stop']
tutu	['voiceless, dental, oral, stop', 'voiceless, dental, oral, stop']
tūtui	['voiceless, dental, oral, stop', 'voiceless, dental, oral, stop']
tuwha	['voiceless, dental, oral, stop', 'voiceless, labio-dental, oral, fricative']
tuwhera	['voiceless, dental, oral, stop', 'voiceless, labio-dental, oral, fricative', 'voiced, dental-alveolar, oral, flap']
tūwhiti	['voiceless, dental, oral, stop', 'voiceless, labio-dental, oral, fricative', 'voiceless, dental, oral, stop']
ua	[]
uara	['voiced, dental-alveolar, oral, flap']
ui	[]
uiui	[]
uku	['voiceless, velar, oral, stop']
ukui	['voiceless, velar, oral, stop']
umere	['voiced, bilabial, nasal, stop', 'voiced, dental-alveolar, oral, flap']
unga	['voiced, velar, nasal, stop']
unu	['voiced, dental, nasal, stop']
uru	['voiced, dental-alveolar, oral, flap']
urungi	['voiced, dental-alveolar, oral, flap', 'voiced, velar, nasal, stop']
uruumu	['voiced, dental-alveolar, oral, flap', 'voiced, bilabial, nasal, stop']
uta	['voiceless, dental, oral, stop']
utu	['voiceless, dental, oral, stop']
uutonga	['voiceless, dental, oral, stop', 'voiced, velar, nasal, stop']
uwhi	['voiceless, labio-dental, oral, fricative']
uwhiuwhi	['voiceless, labio-dental, oral, fricative', 'voiceless, labio-dental, oral, fricative']
waahi	['voiced, bilabial, oral, approximant', 'voiceless, glottal, oral, fricative']
waawaahi	['voiced, bilabial, oral, approximant', 'voiced, bilabial, oral, approximant', 'voiceless, glottal, oral, fricative']
waea	['voiced, bilabial, oral, approximant']
waere	['voiced, bilabial, oral, approximant', 'voiced, dental-alveolar, oral, flap']
waha	['voiced, bilabial, oral, approximant', 'voiceless, glottal, oral, fricative']
wai	['voiced, bilabial, oral, approximant']
waiata	['voiced, bilabial, oral, approximant', 'voiceless, dental, oral, stop']
waiho	['voiced, bilabial, oral, approximant', 'voiceless, glottal, oral, fricative']
waikeri	['voiced, bilabial, oral, approximant', 'voiceless, velar, oral, stop', 'voiced, dental-alveolar, oral, flap']
waimeha	['voiced, bilabial, oral, approximant', 'voiced, bilabial, nasal, stop', 'voiceless, glottal, oral, fricative']
waipuke	['voiced, bilabial, oral, approximant', 'voiceless, bilabial, oral, stop', 'voiceless, velar, oral, stop']
wani	['voiced, bilabial, oral, approximant', 'voiced, dental, nasal, stop']
ware	['voiced, bilabial, oral, approximant', 'voiced, dental-alveolar, oral, flap']
wareware	['voiced, bilabial, oral, approximant', 'voiced, dental-alveolar, oral, flap', 'voiced, bilabial, oral, approximant', 'voiced, dental-alveolar, oral, flap']
waru	['voiced, bilabial, oral, approximant', 'voiced, dental-alveolar, oral, flap']
wawae	['voiced, bilabial, oral, approximant', 'voiced, bilabial, oral, approximant']
wawata	['voiced, bilabial, oral, approximant', 'voiced, bilabial, oral, approximant', 'voiceless, dental, oral, stop']
wehe	['voiced, bilabial, oral, approximant', 'voiceless, glottal, oral, fricative']
wehewehe	['voiced, bilabial, oral, approximant', 'voiceless, glottal, oral, fricative', 'voiced, bilabial, oral, approximant', 'voiceless, glottal, oral, fricative']
weku	['voiced, bilabial, oral, approximant', 'voiceless, velar, oral, stop']
wepu	['voiced, bilabial, oral, approximant', 'voiceless, bilabial, oral, stop']
wero	['voiced, bilabial, oral, approximant', 'voiced, dental-alveolar, oral, flap']
wete	['voiced, bilabial, oral, approximant', 'voiceless, dental, oral, stop']
wete	['voiced, bilabial, oral, approximant', 'voiceless, dental, oral, stop']
wetewete	['voiced, bilabial, oral, approximant', 'voiceless, dental, oral, stop', 'voiced, bilabial, oral, approximant', 'voiceless, dental, oral, stop']
whaaki	['voiceless, labio-dental, oral, fricative', 'voiceless, velar, oral, stop']
whaanako	['voiceless, labio-dental, oral, fricative', 'voiced, dental, nasal, stop', 'voiceless, velar, oral, stop']
whaangai	['voiceless, labio-dental, oral, fricative', 'voiced, velar, nasal, stop']
whaariki	['voiceless, labio-dental, oral, fricative', 'voiced, dental-alveolar, oral, flap', 'voiceless, velar, oral, stop']
whaawhaa	['voiceless, labio-dental, oral, fricative', 'voiceless, labio-dental, oral, fricative']
whai	['voiceless, labio-dental, oral, fricative']
whaiere	['voiceless, labio-dental, oral, fricative', 'voiced, dental-alveolar, oral, flap']
whaikōrero	['voiceless, labio-dental, oral, fricative', 'voiceless, velar, oral, stop', 'voiced, dental-alveolar, oral, flap', 'voiced, dental-alveolar, oral, flap']
whaina	['voiceless, labio-dental, oral, fricative', 'voiced, dental, nasal, stop']
whaiwhai	['voiceless, labio-dental, oral, fricative', 'voiceless, labio-dental, oral, fricative']
whakaae	['voiceless, labio-dental, oral, fricative', 'voiceless, velar, oral, stop']
whakaahu	['voiceless, labio-dental, oral, fricative', 'voiceless, velar, oral, stop', 'voiceless, glottal, oral, fricative']
whakaahua	['voiceless, labio-dental, oral, fricative', 'voiceless, velar, oral, stop', 'voiceless, glottal, oral, fricative']
whakaahuru	['voiceless, labio-dental, oral, fricative', 'voiceless, velar, oral, stop', 'voiceless, glottal, oral, fricative', 'voiced, dental-alveolar, oral, flap']
whakaakakahu	['voiceless, labio-dental, oral, fricative', 'voiceless, velar, oral, stop', 'voiceless, velar, oral, stop', 'voiceless, velar, oral, stop', 'voiceless, glottal, oral, fricative']
whakaako	['voiceless, labio-dental, oral, fricative', 'voiceless, velar, oral, stop', 'voiceless, velar, oral, stop']
whakaara	['voiceless, labio-dental, oral, fricative', 'voiceless, velar, oral, stop', 'voiced, dental-alveolar, oral, flap']
whakaari	['voiceless, labio-dental, oral, fricative', 'voiceless, velar, oral, stop', 'voiced, dental-alveolar, oral, flap']
whakaaro	['voiceless, labio-dental, oral, fricative', 'voiceless, velar, oral, stop', 'voiced, dental-alveolar, oral, flap']
whakaatamira	['voiceless, labio-dental, oral, fricative', 'voiceless, velar, oral, stop', 'voiceless, dental, oral, stop', 'voiced, bilabial, nasal, stop', 'voiced, dental-alveolar, oral, flap']
whakaatu	['voiceless, labio-dental, oral, fricative', 'voiceless, velar, oral, stop', 'voiceless, dental, oral, stop']
whakaea	['voiceless, labio-dental, oral, fricative', 'voiceless, velar, oral, stop']
whakaeaea	['voiceless, labio-dental, oral, fricative', 'voiceless, velar, oral, stop']
whakaeke	['voiceless, labio-dental, oral, fricative', 'voiceless, velar, oral, stop', 'voiceless, velar, oral, stop']
whakaemi	['voiceless, labio-dental, oral, fricative', 'voiceless, velar, oral, stop', 'voiced, bilabial, nasal, stop']
whakaene	['voiceless, labio-dental, oral, fricative', 'voiceless, velar, oral, stop', 'voiced, dental, nasal, stop']
whakaero	['voiceless, labio-dental, oral, fricative', 'voiceless, velar, oral, stop', 'voiced, dental-alveolar, oral, flap']
whakahaawe	['voiceless, labio-dental, oral, fricative', 'voiceless, velar, oral, stop', 'voiceless, glottal, oral, fricative', 'voiced, bilabial, oral, approximant']
whakahaawea	['voiceless, labio-dental, oral, fricative', 'voiceless, velar, oral, stop', 'voiceless, glottal, oral, fricative', 'voiced, bilabial, oral, approximant']
whakahaere	['voiceless, labio-dental, oral, fricative', 'voiceless, velar, oral, stop', 'voiceless, glottal, oral, fricative', 'voiced, dental-alveolar, oral, flap']
whakahake	['voiceless, labio-dental, oral, fricative', 'voiceless, velar, oral, stop', 'voiceless, glottal, oral, fricative', 'voiceless, velar, oral, stop']
whakahanumi	['voiceless, labio-dental, oral, fricative', 'voiceless, velar, oral, stop', 'voiceless, glottal, oral, fricative', 'voiced, dental, nasal, stop', 'voiced, bilabial, nasal, stop']
whakahau	['voiceless, labio-dental, oral, fricative', 'voiceless, velar, oral, stop', 'voiceless, glottal, oral, fricative']
whakahee	['voiceless, labio-dental, oral, fricative', 'voiceless, velar, oral, stop', 'voiceless, glottal, oral, fricative']
whakaheke	['voiceless, labio-dental, oral, fricative', 'voiceless, velar, oral, stop', 'voiceless, glottal, oral, fricative', 'voiceless, velar, oral, stop']
whakahemo	['voiceless, labio-dental, oral, fricative', 'voiceless, velar, oral, stop', 'voiceless, glottal, oral, fricative', 'voiced, bilabial, nasal, stop']
whakahere	['voiceless, labio-dental, oral, fricative', 'voiceless, velar, oral, stop', 'voiceless, glottal, oral, fricative', 'voiced, dental-alveolar, oral, flap']
whakahinga	['voiceless, labio-dental, oral, fricative', 'voiceless, velar, oral, stop', 'voiceless, glottal, oral, fricative', 'voiced, velar, nasal, stop']
whakahoa	['voiceless, labio-dental, oral, fricative', 'voiceless, velar, oral, stop', 'voiceless, glottal, oral, fricative']
whakahohori	['voiceless, labio-dental, oral, fricative', 'voiceless, velar, oral, stop', 'voiceless, glottal, oral, fricative', 'voiceless, glottal, oral, fricative', 'voiced, dental-alveolar, oral, flap']
whakahohoro	['voiceless, labio-dental, oral, fricative', 'voiceless, velar, oral, stop', 'voiceless, glottal, oral, fricative', 'voiceless, glottal, oral, fricative', 'voiced, dental-alveolar, oral, flap']
whakahoki	['voiceless, labio-dental, oral, fricative', 'voiceless, velar, oral, stop', 'voiceless, glottal, oral, fricative', 'voiceless, velar, oral, stop']
whakahōnore	['voiceless, labio-dental, oral, fricative', 'voiceless, velar, oral, stop', 'voiceless, glottal, oral, fricative', 'voiced, dental, nasal, stop', 'voiced, dental-alveolar, oral, flap']
whakahori	['voiceless, labio-dental, oral, fricative', 'voiceless, velar, oral, stop', 'voiceless, glottal, oral, fricative', 'voiced, dental-alveolar, oral, flap']
whakahoro	['voiceless, labio-dental, oral, fricative', 'voiceless, velar, oral, stop', 'voiceless, glottal, oral, fricative', 'voiced, dental-alveolar, oral, flap']
whakahorohoro	['voiceless, labio-dental, oral, fricative', 'voiceless, velar, oral, stop', 'voiceless, glottal, oral, fricative', 'voiced, dental-alveolar, oral, flap', 'voiceless, glottal, oral, fricative', 'voiced, dental-alveolar, oral, flap']
whakahua	['voiceless, labio-dental, oral, fricative', 'voiceless, velar, oral, stop', 'voiceless, glottal, oral, fricative']
whakaihi	['voiceless, labio-dental, oral, fricative', 'voiceless, velar, oral, stop', 'voiceless, glottal, oral, fricative']
whakaingoa	['voiceless, labio-dental, oral, fricative', 'voiceless, velar, oral, stop', 'voiced, velar, nasal, stop']
whakainu	['voiceless, labio-dental, oral, fricative', 'voiceless, velar, oral, stop', 'voiced, dental, nasal, stop']
whakaipo	['voiceless, labio-dental, oral, fricative', 'voiceless, velar, oral, stop', 'voiceless, bilabial, oral, stop']
whakaipoipo	['voiceless, labio-dental, oral, fricative', 'voiceless, velar, oral, stop', 'voiceless, bilabial, oral, stop', 'voiceless, bilabial, oral, stop']
whakairi	['voiceless, labio-dental, oral, fricative', 'voiceless, velar, oral, stop', 'voiced, dental-alveolar, oral, flap']
whakairo	['voiceless, labio-dental, oral, fricative', 'voiceless, velar, oral, stop', 'voiced, dental-alveolar, oral, flap']
whakaiti	['voiceless, labio-dental, oral, fricative', 'voiceless, velar, oral, stop', 'voiceless, dental, oral, stop']
whakakā	['voiceless, labio-dental, oral, fricative', 'voiceless, velar, oral, stop', 'voiceless, velar, oral, stop']
whakakaha	['voiceless, labio-dental, oral, fricative', 'voiceless, velar, oral, stop', 'voiceless, velar, oral, stop', 'voiceless, glottal, oral, fricative']
whakakahaki	['voiceless, labio-dental, oral, fricative', 'voiceless, velar, oral, stop', 'voiceless, velar, oral, stop', 'voiceless, glottal, oral, fricative', 'voiceless, velar, oral, stop']
whakakāhore	['voiceless, labio-dental, oral, fricative', 'voiceless, velar, oral, stop', 'voiceless, velar, oral, stop', 'voiceless, glottal, oral, fricative', 'voiced, dental-alveolar, oral, flap']
whakakai	['voiceless, labio-dental, oral, fricative', 'voiceless, velar, oral, stop', 'voiceless, velar, oral, stop']
whakakakara	['voiceless, labio-dental, oral, fricative', 'voiceless, velar, oral, stop', 'voiceless, velar, oral, stop', 'voiceless, velar, oral, stop', 'voiced, dental-alveolar, oral, flap']
whakakake	['voiceless, labio-dental, oral, fricative', 'voiceless, velar, oral, stop', 'voiceless, velar, oral, stop', 'voiceless, velar, oral, stop']
whakakāniwha	['voiceless, labio-dental, oral, fricative', 'voiceless, velar, oral, stop', 'voiceless, velar, oral, stop', 'voiced, dental, nasal, stop', 'voiceless, labio-dental, oral, fricative']
whakakao	['voiceless, labio-dental, oral, fricative', 'voiceless, velar, oral, stop', 'voiceless, velar, oral, stop']
whakakapi	['voiceless, labio-dental, oral, fricative', 'voiceless, velar, oral, stop', 'voiceless, velar, oral, stop', 'voiceless, bilabial, oral, stop']
whakakikī	['voiceless, labio-dental, oral, fricative', 'voiceless, velar, oral, stop', 'voiceless, velar, oral, stop', 'voiceless, velar, oral, stop']
whakakino	['voiceless, labio-dental, oral, fricative', 'voiceless, velar, oral, stop', 'voiceless, velar, oral, stop', 'voiced, dental, nasal, stop']
whakakite	['voiceless, labio-dental, oral, fricative', 'voiceless, velar, oral, stop', 'voiceless, velar, oral, stop', 'voiceless, dental, oral, stop']
whakakoi	['voiceless, labio-dental, oral, fricative', 'voiceless, velar, oral, stop', 'voiceless, velar, oral, stop']
whakakopakopa	['voiceless, labio-dental, oral, fricative', 'voiceless, velar, oral, stop', 'voiceless, velar, oral, stop', 'voiceless, bilabial, oral, stop', 'voiceless, velar, oral, stop', 'voiceless, bilabial, oral, stop']
whakakōpeke	['voiceless, labio-dental, oral, fricative', 'voiceless, velar, oral, stop', 'voiceless, velar, oral, stop', 'voiceless, bilabial, oral, stop', 'voiceless, velar, oral, stop']
whakakopi	['voiceless, labio-dental, oral, fricative', 'voiceless, velar, oral, stop', 'voiceless, velar, oral, stop', 'voiceless, bilabial, oral, stop']
whakakore	['voiceless, labio-dental, oral, fricative', 'voiceless, velar, oral, stop', 'voiceless, velar, oral, stop', 'voiced, dental-alveolar, oral, flap']
whakakorokoro	['voiceless, labio-dental, oral, fricative', 'voiceless, velar, oral, stop', 'voiceless, velar, oral, stop', 'voiced, dental-alveolar, oral, flap', 'voiceless, velar, oral, stop', 'voiced, dental-alveolar, oral, flap']
whakakoromeke	['voiceless, labio-dental, oral, fricative', 'voiceless, velar, oral, stop', 'voiceless, velar, oral, stop', 'voiced, dental-alveolar, oral, flap', 'voiced, bilabial, nasal, stop', 'voiceless, velar, oral, stop']
whakakōrua	['voiceless, labio-dental, oral, fricative', 'voiceless, velar, oral, stop', 'voiceless, velar, oral, stop', 'voiced, dental-alveolar, oral, flap']
whakamahana	['voiceless, labio-dental, oral, fricative', 'voiceless, velar, oral, stop', 'voiced, bilabial, nasal, stop', 'voiceless, glottal, oral, fricative', 'voiced, dental, nasal, stop']
whakamahara	['voiceless, labio-dental, oral, fricative', 'voiceless, velar, oral, stop', 'voiced, bilabial, nasal, stop', 'voiceless, glottal, oral, fricative', 'voiced, dental-alveolar, oral, flap']
whakamahi	['voiceless, labio-dental, oral, fricative', 'voiceless, velar, oral, stop', 'voiced, bilabial, nasal, stop', 'voiceless, glottal, oral, fricative']
whakamākūkū	['voiceless, labio-dental, oral, fricative', 'voiceless, velar, oral, stop', 'voiced, bilabial, nasal, stop', 'voiceless, velar, oral, stop', 'voiceless, velar, oral, stop']
whakamāmā	['voiceless, labio-dental, oral, fricative', 'voiceless, velar, oral, stop', 'voiced, bilabial, nasal, stop', 'voiced, bilabial, nasal, stop']
whakamamae	['voiceless, labio-dental, oral, fricative', 'voiceless, velar, oral, stop', 'voiced, bilabial, nasal, stop', 'voiced, bilabial, nasal, stop']
whakamana	['voiceless, labio-dental, oral, fricative', 'voiceless, velar, oral, stop', 'voiced, bilabial, nasal, stop', 'voiced, dental, nasal, stop']
whakamanawa	['voiceless, labio-dental, oral, fricative', 'voiceless, velar, oral, stop', 'voiced, bilabial, nasal, stop', 'voiced, dental, nasal, stop', 'voiced, bilabial, oral, approximant']
whakamānu	['voiceless, labio-dental, oral, fricative', 'voiceless, velar, oral, stop', 'voiced, bilabial, nasal, stop', 'voiced, dental, nasal, stop']
whakamāoa	['voiceless, labio-dental, oral, fricative', 'voiceless, velar, oral, stop', 'voiced, bilabial, nasal, stop']
whakamāori	['voiceless, labio-dental, oral, fricative', 'voiceless, velar, oral, stop', 'voiced, bilabial, nasal, stop', 'voiced, dental-alveolar, oral, flap']
whakamārama	['voiceless, labio-dental, oral, fricative', 'voiceless, velar, oral, stop', 'voiced, bilabial, nasal, stop', 'voiced, dental-alveolar, oral, flap', 'voiced, bilabial, nasal, stop']
whakamārie	['voiceless, labio-dental, oral, fricative', 'voiceless, velar, oral, stop', 'voiced, bilabial, nasal, stop', 'voiced, dental-alveolar, oral, flap']
whakamaroke	['voiceless, labio-dental, oral, fricative', 'voiceless, velar, oral, stop', 'voiced, bilabial, nasal, stop', 'voiced, dental-alveolar, oral, flap', 'voiceless, velar, oral, stop']
whakamārōrō	['voiceless, labio-dental, oral, fricative', 'voiceless, velar, oral, stop', 'voiced, bilabial, nasal, stop', 'voiced, dental-alveolar, oral, flap', 'voiced, dental-alveolar, oral, flap']
whakamataku	['voiceless, labio-dental, oral, fricative', 'voiceless, velar, oral, stop', 'voiced, bilabial, nasal, stop', 'voiceless, dental, oral, stop', 'voiceless, velar, oral, stop']
whakamātaotao	['voiceless, labio-dental, oral, fricative', 'voiceless, velar, oral, stop', 'voiced, bilabial, nasal, stop', 'voiceless, dental, oral, stop', 'voiceless, dental, oral, stop']
whakamātau	['voiceless, labio-dental, oral, fricative', 'voiceless, velar, oral, stop', 'voiced, bilabial, nasal, stop', 'voiceless, dental, oral, stop']
whakamātautau	['voiceless, labio-dental, oral, fricative', 'voiceless, velar, oral, stop', 'voiced, bilabial, nasal, stop', 'voiceless, dental, oral, stop', 'voiceless, dental, oral, stop']
whakamate	['voiceless, labio-dental, oral, fricative', 'voiceless, velar, oral, stop', 'voiced, bilabial, nasal, stop', 'voiceless, dental, oral, stop']
whakamau	['voiceless, labio-dental, oral, fricative', 'voiceless, velar, oral, stop', 'voiced, bilabial, nasal, stop']
whakamihi	['voiceless, labio-dental, oral, fricative', 'voiceless, velar, oral, stop', 'voiced, bilabial, nasal, stop', 'voiceless, glottal, oral, fricative']
whakamiiharo	['voiceless, labio-dental, oral, fricative', 'voiceless, velar, oral, stop', 'voiced, bilabial, nasal, stop', 'voiceless, glottal, oral, fricative', 'voiced, dental-alveolar, oral, flap']
whakamine	['voiceless, labio-dental, oral, fricative', 'voiceless, velar, oral, stop', 'voiced, bilabial, nasal, stop', 'voiced, dental, nasal, stop']
whakamoe	['voiceless, labio-dental, oral, fricative', 'voiceless, velar, oral, stop', 'voiced, bilabial, nasal, stop']
whakamōhio	['voiceless, labio-dental, oral, fricative', 'voiceless, velar, oral, stop', 'voiced, bilabial, nasal, stop', 'voiceless, glottal, oral, fricative']
whakamōkā	['voiceless, labio-dental, oral, fricative', 'voiceless, velar, oral, stop', 'voiced, bilabial, nasal, stop', 'voiceless, velar, oral, stop']
whakamuri	['voiceless, labio-dental, oral, fricative', 'voiceless, velar, oral, stop', 'voiced, bilabial, nasal, stop', 'voiced, dental-alveolar, oral, flap']
whakamutu	['voiceless, labio-dental, oral, fricative', 'voiceless, velar, oral, stop', 'voiced, bilabial, nasal, stop', 'voiceless, dental, oral, stop']
whakananu	['voiceless, labio-dental, oral, fricative', 'voiceless, velar, oral, stop', 'voiced, dental, nasal, stop', 'voiced, dental, nasal, stop']
whakangaere	['voiceless, labio-dental, oral, fricative', 'voiceless, velar, oral, stop', 'voiced, velar, nasal, stop', 'voiced, dental-alveolar, oral, flap']
whakangahau	['voiceless, labio-dental, oral, fricative', 'voiceless, velar, oral, stop', 'voiced, velar, nasal, stop', 'voiceless, glottal, oral, fricative']
whakangahoro	['voiceless, labio-dental, oral, fricative', 'voiceless, velar, oral, stop', 'voiced, velar, nasal, stop', 'voiceless, glottal, oral, fricative', 'voiced, dental-alveolar, oral, flap']
whakangaro	['voiceless, labio-dental, oral, fricative', 'voiceless, velar, oral, stop', 'voiced, velar, nasal, stop', 'voiced, dental-alveolar, oral, flap']
whakangau	['voiceless, labio-dental, oral, fricative', 'voiceless, velar, oral, stop', 'voiced, velar, nasal, stop']
whakangāwari	['voiceless, labio-dental, oral, fricative', 'voiceless, velar, oral, stop', 'voiced, velar, nasal, stop', 'voiced, bilabial, oral, approximant', 'voiced, dental-alveolar, oral, flap']
whakanoa	['voiceless, labio-dental, oral, fricative', 'voiceless, velar, oral, stop', 'voiced, dental, nasal, stop']
whakanoho	['voiceless, labio-dental, oral, fricative', 'voiceless, velar, oral, stop', 'voiced, dental, nasal, stop', 'voiceless, glottal, oral, fricative']
whakanui	['voiceless, labio-dental, oral, fricative', 'voiceless, velar, oral, stop', 'voiced, dental, nasal, stop']
whakaoho	['voiceless, labio-dental, oral, fricative', 'voiceless, velar, oral, stop', 'voiceless, glottal, oral, fricative']
whakaora	['voiceless, labio-dental, oral, fricative', 'voiceless, velar, oral, stop', 'voiced, dental-alveolar, oral, flap']
whakaoti	['voiceless, labio-dental, oral, fricative', 'voiceless, velar, oral, stop', 'voiceless, dental, oral, stop']
whakapā	['voiceless, labio-dental, oral, fricative', 'voiceless, velar, oral, stop', 'voiceless, bilabial, oral, stop']
whakapae	['voiceless, labio-dental, oral, fricative', 'voiceless, velar, oral, stop', 'voiceless, bilabial, oral, stop']
whakapai	['voiceless, labio-dental, oral, fricative', 'voiceless, velar, oral, stop', 'voiceless, bilabial, oral, stop']
whakapaipai	['voiceless, labio-dental, oral, fricative', 'voiceless, velar, oral, stop', 'voiceless, bilabial, oral, stop', 'voiceless, bilabial, oral, stop']
whakapakeke	['voiceless, labio-dental, oral, fricative', 'voiceless, velar, oral, stop', 'voiceless, bilabial, oral, stop', 'voiceless, velar, oral, stop', 'voiceless, velar, oral, stop']
whakapakoko	['voiceless, labio-dental, oral, fricative', 'voiceless, velar, oral, stop', 'voiceless, bilabial, oral, stop', 'voiceless, velar, oral, stop', 'voiceless, velar, oral, stop']
whakapapa	['voiceless, labio-dental, oral, fricative', 'voiceless, velar, oral, stop', 'voiceless, bilabial, oral, stop', 'voiceless, bilabial, oral, stop']
whakaparahako	['voiceless, labio-dental, oral, fricative', 'voiceless, velar, oral, stop', 'voiceless, bilabial, oral, stop', 'voiced, dental-alveolar, oral, flap', 'voiceless, glottal, oral, fricative', 'voiceless, velar, oral, stop']
whakaparu	['voiceless, labio-dental, oral, fricative', 'voiceless, velar, oral, stop', 'voiceless, bilabial, oral, stop', 'voiced, dental-alveolar, oral, flap']
whakapau	['voiceless, labio-dental, oral, fricative', 'voiceless, velar, oral, stop', 'voiceless, bilabial, oral, stop']
whakapiata	['voiceless, labio-dental, oral, fricative', 'voiceless, velar, oral, stop', 'voiceless, bilabial, oral, stop', 'voiceless, dental, oral, stop']
whakapiko	['voiceless, labio-dental, oral, fricative', 'voiceless, velar, oral, stop', 'voiceless, bilabial, oral, stop', 'voiceless, velar, oral, stop']
whakapiri	['voiceless, labio-dental, oral, fricative', 'voiceless, velar, oral, stop', 'voiceless, bilabial, oral, stop', 'voiced, dental-alveolar, oral, flap']
whakapōhēhē	['voiceless, labio-dental, oral, fricative', 'voiceless, velar, oral, stop', 'voiceless, bilabial, oral, stop', 'voiceless, glottal, oral, fricative', 'voiceless, glottal, oral, fricative']
whakapokorua	['voiceless, labio-dental, oral, fricative', 'voiceless, velar, oral, stop', 'voiceless, bilabial, oral, stop', 'voiceless, velar, oral, stop', 'voiced, dental-alveolar, oral, flap']
whakapono	['voiceless, labio-dental, oral, fricative', 'voiceless, velar, oral, stop', 'voiceless, bilabial, oral, stop', 'voiced, dental, nasal, stop']
whakapoto	['voiceless, labio-dental, oral, fricative', 'voiceless, velar, oral, stop', 'voiceless, bilabial, oral, stop', 'voiceless, dental, oral, stop']
whakapua	['voiceless, labio-dental, oral, fricative', 'voiceless, velar, oral, stop', 'voiceless, bilabial, oral, stop']
whakapuaki	['voiceless, labio-dental, oral, fricative', 'voiceless, velar, oral, stop', 'voiceless, bilabial, oral, stop', 'voiceless, velar, oral, stop']
whakapuare	['voiceless, labio-dental, oral, fricative', 'voiceless, velar, oral, stop', 'voiceless, bilabial, oral, stop', 'voiced, dental-alveolar, oral, flap']
whakapuhari	['voiceless, labio-dental, oral, fricative', 'voiceless, velar, oral, stop', 'voiceless, bilabial, oral, stop', 'voiceless, glottal, oral, fricative', 'voiced, dental-alveolar, oral, flap']
whakapuhi	['voiceless, labio-dental, oral, fricative', 'voiceless, velar, oral, stop', 'voiceless, bilabial, oral, stop', 'voiceless, glottal, oral, fricative']
whakapūmau	['voiceless, labio-dental, oral, fricative', 'voiceless, velar, oral, stop', 'voiceless, bilabial, oral, stop', 'voiced, bilabial, nasal, stop']
whakapuru	['voiceless, labio-dental, oral, fricative', 'voiceless, velar, oral, stop', 'voiceless, bilabial, oral, stop', 'voiced, dental-alveolar, oral, flap']
whakaputa	['voiceless, labio-dental, oral, fricative', 'voiceless, velar, oral, stop', 'voiceless, bilabial, oral, stop', 'voiceless, dental, oral, stop']
whakarangatira	['voiceless, labio-dental, oral, fricative', 'voiceless, velar, oral, stop', 'voiced, dental-alveolar, oral, flap', 'voiced, velar, nasal, stop', 'voiceless, dental, oral, stop', 'voiced, dental-alveolar, oral, flap']
whakaranu	['voiceless, labio-dental, oral, fricative', 'voiceless, velar, oral, stop', 'voiced, dental-alveolar, oral, flap', 'voiced, dental, nasal, stop']
whakarapa	['voiceless, labio-dental, oral, fricative', 'voiceless, velar, oral, stop', 'voiced, dental-alveolar, oral, flap', 'voiceless, bilabial, oral, stop']
whakarapihi	['voiceless, labio-dental, oral, fricative', 'voiceless, velar, oral, stop', 'voiced, dental-alveolar, oral, flap', 'voiceless, bilabial, oral, stop', 'voiceless, glottal, oral, fricative']
whakarāpopoto	['voiceless, labio-dental, oral, fricative', 'voiceless, velar, oral, stop', 'voiced, dental-alveolar, oral, flap', 'voiceless, bilabial, oral, stop', 'voiceless, bilabial, oral, stop', 'voiceless, dental, oral, stop']
whakararu	['voiceless, labio-dental, oral, fricative', 'voiceless, velar, oral, stop', 'voiced, dental-alveolar, oral, flap', 'voiced, dental-alveolar, oral, flap']
whakarato	['voiceless, labio-dental, oral, fricative', 'voiceless, velar, oral, stop', 'voiced, dental-alveolar, oral, flap', 'voiceless, dental, oral, stop']
whakarawa	['voiceless, labio-dental, oral, fricative', 'voiceless, velar, oral, stop', 'voiced, dental-alveolar, oral, flap', 'voiced, bilabial, oral, approximant']
whakarāwai	['voiceless, labio-dental, oral, fricative', 'voiceless, velar, oral, stop', 'voiced, dental-alveolar, oral, flap', 'voiced, bilabial, oral, approximant']
whakarawe	['voiceless, labio-dental, oral, fricative', 'voiceless, velar, oral, stop', 'voiced, dental-alveolar, oral, flap', 'voiced, bilabial, oral, approximant']
whakareka	['voiceless, labio-dental, oral, fricative', 'voiceless, velar, oral, stop', 'voiced, dental-alveolar, oral, flap', 'voiceless, velar, oral, stop']
whakarere	['voiceless, labio-dental, oral, fricative', 'voiceless, velar, oral, stop', 'voiced, dental-alveolar, oral, flap', 'voiced, dental-alveolar, oral, flap']
whakareri	['voiceless, labio-dental, oral, fricative', 'voiceless, velar, oral, stop', 'voiced, dental-alveolar, oral, flap', 'voiced, dental-alveolar, oral, flap']
whakarewa	['voiceless, labio-dental, oral, fricative', 'voiceless, velar, oral, stop', 'voiced, dental-alveolar, oral, flap', 'voiced, bilabial, oral, approximant']
whakaririki	['voiceless, labio-dental, oral, fricative', 'voiceless, velar, oral, stop', 'voiced, dental-alveolar, oral, flap', 'voiced, dental-alveolar, oral, flap', 'voiceless, velar, oral, stop']
whakariro	['voiceless, labio-dental, oral, fricative', 'voiceless, velar, oral, stop', 'voiced, dental-alveolar, oral, flap', 'voiced, dental-alveolar, oral, flap']
whakarite	['voiceless, labio-dental, oral, fricative', 'voiceless, velar, oral, stop', 'voiced, dental-alveolar, oral, flap', 'voiceless, dental, oral, stop']
whakaroa	['voiceless, labio-dental, oral, fricative', 'voiceless, velar, oral, stop', 'voiced, dental-alveolar, oral, flap']
whakarongo	['voiceless, labio-dental, oral, fricative', 'voiceless, velar, oral, stop', 'voiced, dental-alveolar, oral, flap', 'voiced, velar, nasal, stop']
whakataetae	['voiceless, labio-dental, oral, fricative', 'voiceless, velar, oral, stop', 'voiceless, dental, oral, stop', 'voiceless, dental, oral, stop']
whakatahe	['voiceless, labio-dental, oral, fricative', 'voiceless, velar, oral, stop', 'voiceless, dental, oral, stop', 'voiceless, glottal, oral, fricative']
whakatahuri	['voiceless, labio-dental, oral, fricative', 'voiceless, velar, oral, stop', 'voiceless, dental, oral, stop', 'voiceless, glottal, oral, fricative', 'voiced, dental-alveolar, oral, flap']
whakatairanga	['voiceless, labio-dental, oral, fricative', 'voiceless, velar, oral, stop', 'voiceless, dental, oral, stop', 'voiced, dental-alveolar, oral, flap', 'voiced, velar, nasal, stop']
whakatākaro	['voiceless, labio-dental, oral, fricative', 'voiceless, velar, oral, stop', 'voiceless, dental, oral, stop', 'voiceless, velar, oral, stop', 'voiced, dental-alveolar, oral, flap']
whakataki	['voiceless, labio-dental, oral, fricative', 'voiceless, velar, oral, stop', 'voiceless, dental, oral, stop', 'voiceless, velar, oral, stop']
whakatakitaki	['voiceless, labio-dental, oral, fricative', 'voiceless, velar, oral, stop', 'voiceless, dental, oral, stop', 'voiceless, velar, oral, stop', 'voiceless, dental, oral, stop', 'voiceless, velar, oral, stop']
whakatakoto	['voiceless, labio-dental, oral, fricative', 'voiceless, velar, oral, stop', 'voiceless, dental, oral, stop', 'voiceless, velar, oral, stop', 'voiceless, dental, oral, stop']
whakatākotokoto	['voiceless, labio-dental, oral, fricative', 'voiceless, velar, oral, stop', 'voiceless, dental, oral, stop', 'voiceless, velar, oral, stop', 'voiceless, dental, oral, stop', 'voiceless, velar, oral, stop', 'voiceless, dental, oral, stop']
whakatangitangi	['voiceless, labio-dental, oral, fricative', 'voiceless, velar, oral, stop', 'voiceless, dental, oral, stop', 'voiced, velar, nasal, stop', 'voiceless, dental, oral, stop', 'voiced, velar, nasal, stop']
whakatanuku	['voiceless, labio-dental, oral, fricative', 'voiceless, velar, oral, stop', 'voiceless, dental, oral, stop', 'voiced, dental, nasal, stop', 'voiceless, velar, oral, stop']
whakatapu	['voiceless, labio-dental, oral, fricative', 'voiceless, velar, oral, stop', 'voiceless, dental, oral, stop', 'voiceless, bilabial, oral, stop']
whakatara	['voiceless, labio-dental, oral, fricative', 'voiceless, velar, oral, stop', 'voiceless, dental, oral, stop', 'voiced, dental-alveolar, oral, flap']
whakataratara	['voiceless, labio-dental, oral, fricative', 'voiceless, velar, oral, stop', 'voiceless, dental, oral, stop', 'voiced, dental-alveolar, oral, flap', 'voiceless, dental, oral, stop', 'voiced, dental-alveolar, oral, flap']
whakatata	['voiceless, labio-dental, oral, fricative', 'voiceless, velar, oral, stop', 'voiceless, dental, oral, stop', 'voiceless, dental, oral, stop']
whakatata	['voiceless, labio-dental, oral, fricative', 'voiceless, velar, oral, stop', 'voiceless, dental, oral, stop', 'voiceless, dental, oral, stop']
whakatau	['voiceless, labio-dental, oral, fricative', 'voiceless, velar, oral, stop', 'voiceless, dental, oral, stop']
whakataurite	['voiceless, labio-dental, oral, fricative', 'voiceless, velar, oral, stop', 'voiceless, dental, oral, stop', 'voiced, dental-alveolar, oral, flap', 'voiceless, dental, oral, stop']
whakatika	['voiceless, labio-dental, oral, fricative', 'voiceless, velar, oral, stop', 'voiceless, dental, oral, stop', 'voiceless, velar, oral, stop']
whakatikatika	['voiceless, labio-dental, oral, fricative', 'voiceless, velar, oral, stop', 'voiceless, dental, oral, stop', 'voiceless, velar, oral, stop', 'voiceless, dental, oral, stop', 'voiceless, velar, oral, stop']
whakatīmata	['voiceless, labio-dental, oral, fricative', 'voiceless, velar, oral, stop', 'voiceless, dental, oral, stop', 'voiced, bilabial, nasal, stop', 'voiceless, dental, oral, stop']
whakatina	['voiceless, labio-dental, oral, fricative', 'voiceless, velar, oral, stop', 'voiceless, dental, oral, stop', 'voiced, dental, nasal, stop']
whakatipu	['voiceless, labio-dental, oral, fricative', 'voiceless, velar, oral, stop', 'voiceless, dental, oral, stop', 'voiceless, bilabial, oral, stop']
whakatiraha	['voiceless, labio-dental, oral, fricative', 'voiceless, velar, oral, stop', 'voiceless, dental, oral, stop', 'voiced, dental-alveolar, oral, flap', 'voiceless, glottal, oral, fricative']
whakatō	['voiceless, labio-dental, oral, fricative', 'voiceless, velar, oral, stop', 'voiceless, dental, oral, stop']
whakatoi	['voiceless, labio-dental, oral, fricative', 'voiceless, velar, oral, stop', 'voiceless, dental, oral, stop']
whakatōpū	['voiceless, labio-dental, oral, fricative', 'voiceless, velar, oral, stop', 'voiceless, dental, oral, stop', 'voiceless, bilabial, oral, stop']
whakatū	['voiceless, labio-dental, oral, fricative', 'voiceless, velar, oral, stop', 'voiceless, dental, oral, stop']
whakatūpato	['voiceless, labio-dental, oral, fricative', 'voiceless, velar, oral, stop', 'voiceless, dental, oral, stop', 'voiceless, bilabial, oral, stop', 'voiceless, dental, oral, stop']
whakatupu	['voiceless, labio-dental, oral, fricative', 'voiceless, velar, oral, stop', 'voiceless, dental, oral, stop', 'voiceless, bilabial, oral, stop']
whakatūtehu	['voiceless, labio-dental, oral, fricative', 'voiceless, velar, oral, stop', 'voiceless, dental, oral, stop', 'voiceless, dental, oral, stop', 'voiceless, glottal, oral, fricative']
whakatuwhera	['voiceless, labio-dental, oral, fricative', 'voiceless, velar, oral, stop', 'voiceless, dental, oral, stop', 'voiceless, labio-dental, oral, fricative', 'voiced, dental-alveolar, oral, flap']
whakaū	['voiceless, labio-dental, oral, fricative', 'voiceless, velar, oral, stop']
whakauru	['voiceless, labio-dental, oral, fricative', 'voiceless, velar, oral, stop', 'voiced, dental-alveolar, oral, flap']
whakaurunga	['voiceless, labio-dental, oral, fricative', 'voiceless, velar, oral, stop', 'voiced, dental-alveolar, oral, flap', 'voiced, velar, nasal, stop']
whakautu	['voiceless, labio-dental, oral, fricative', 'voiceless, velar, oral, stop', 'voiceless, dental, oral, stop']
whakawā	['voiceless, labio-dental, oral, fricative', 'voiceless, velar, oral, stop', 'voiced, bilabial, oral, approximant']
whakawahi	['voiceless, labio-dental, oral, fricative', 'voiceless, velar, oral, stop', 'voiced, bilabial, oral, approximant', 'voiceless, glottal, oral, fricative']
whakawai	['voiceless, labio-dental, oral, fricative', 'voiceless, velar, oral, stop', 'voiced, bilabial, oral, approximant']
whakawaireka	['voiceless, labio-dental, oral, fricative', 'voiceless, velar, oral, stop', 'voiced, bilabial, oral, approximant', 'voiced, dental-alveolar, oral, flap', 'voiceless, velar, oral, stop']
whakaware	['voiceless, labio-dental, oral, fricative', 'voiceless, velar, oral, stop', 'voiced, bilabial, oral, approximant', 'voiced, dental-alveolar, oral, flap']
whakawātea	['voiceless, labio-dental, oral, fricative', 'voiceless, velar, oral, stop', 'voiced, bilabial, oral, approximant', 'voiceless, dental, oral, stop']
whakawāwā	['voiceless, labio-dental, oral, fricative', 'voiceless, velar, oral, stop', 'voiced, bilabial, oral, approximant', 'voiced, bilabial, oral, approximant']
whakawehi	['voiceless, labio-dental, oral, fricative', 'voiceless, velar, oral, stop', 'voiced, bilabial, oral, approximant', 'voiceless, glottal, oral, fricative']
whakawhāiti	['voiceless, labio-dental, oral, fricative', 'voiceless, velar, oral, stop', 'voiceless, labio-dental, oral, fricative', 'voiceless, dental, oral, stop']
whakawhānau	['voiceless, labio-dental, oral, fricative', 'voiceless, velar, oral, stop', 'voiceless, labio-dental, oral, fricative', 'voiced, dental, nasal, stop']
whakawherū	['voiceless, labio-dental, oral, fricative', 'voiceless, velar, oral, stop', 'voiceless, labio-dental, oral, fricative', 'voiced, dental-alveolar, oral, flap']
whakawheruu	['voiceless, labio-dental, oral, fricative', 'voiceless, velar, oral, stop', 'voiceless, labio-dental, oral, fricative', 'voiced, dental-alveolar, oral, flap']
whakawhirinaki	['voiceless, labio-dental, oral, fricative', 'voiceless, velar, oral, stop', 'voiceless, labio-dental, oral, fricative', 'voiced, dental-alveolar, oral, flap', 'voiced, dental, nasal, stop', 'voiceless, velar, oral, stop']
whakawhiti	['voiceless, labio-dental, oral, fricative', 'voiceless, velar, oral, stop', 'voiceless, labio-dental, oral, fricative', 'voiceless, dental, oral, stop']
whakawhiu	['voiceless, labio-dental, oral, fricative', 'voiceless, velar, oral, stop', 'voiceless, labio-dental, oral, fricative']
whakawhiwhi	['voiceless, labio-dental, oral, fricative', 'voiceless, velar, oral, stop', 'voiceless, labio-dental, oral, fricative', 'voiceless, labio-dental, oral, fricative']
whakawiri	['voiceless, labio-dental, oral, fricative', 'voiceless, velar, oral, stop', 'voiced, bilabial, oral, approximant', 'voiced, dental-alveolar, oral, flap']
whana	['voiceless, labio-dental, oral, fricative', 'voiced, dental, nasal, stop']
whanowhano	['voiceless, labio-dental, oral, fricative', 'voiced, dental, nasal, stop', 'voiceless, labio-dental, oral, fricative', 'voiced, dental, nasal, stop']
whānui	['voiceless, labio-dental, oral, fricative', 'voiced, dental, nasal, stop']
whao	['voiceless, labio-dental, oral, fricative']
whata	['voiceless, labio-dental, oral, fricative', 'voiceless, dental, oral, stop']
whati	['voiceless, labio-dental, oral, fricative', 'voiceless, dental, oral, stop']
whatiwhati	['voiceless, labio-dental, oral, fricative', 'voiceless, dental, oral, stop', 'voiceless, labio-dental, oral, fricative', 'voiceless, dental, oral, stop']
whatu	['voiceless, labio-dental, oral, fricative', 'voiceless, dental, oral, stop']
whāwhā	['voiceless, labio-dental, oral, fricative', 'voiceless, labio-dental, oral, fricative']
whawhai	['voiceless, labio-dental, oral, fricative', 'voiceless, labio-dental, oral, fricative']
whāwhāi	['voiceless, labio-dental, oral, fricative', 'voiceless, labio-dental, oral, fricative']
wheeraa	['voiceless, labio-dental, oral, fricative', 'voiced, dental-alveolar, oral, flap']
wheo	['voiceless, labio-dental, oral, fricative']
whera	['voiceless, labio-dental, oral, fricative', 'voiced, dental-alveolar, oral, flap']
where	['voiceless, labio-dental, oral, fricative', 'voiced, dental-alveolar, oral, flap']
whetūrangi	['voiceless, labio-dental, oral, fricative', 'voiceless, dental, oral, stop', 'voiced, dental-alveolar, oral, flap', 'voiced, velar, nasal, stop']
whiri	['voiceless, labio-dental, oral, fricative', 'voiced, dental-alveolar, oral, flap']
whiriwhiri	['voiceless, labio-dental, oral, fricative', 'voiced, dental-alveolar, oral, flap', 'voiceless, labio-dental, oral, fricative', 'voiced, dental-alveolar, oral, flap']
whiti	['voiceless, labio-dental, oral, fricative', 'voiceless, dental, oral, stop']
whītiki	['voiceless, labio-dental, oral, fricative', 'voiceless, dental, oral, stop', 'voiceless, velar, oral, stop']
whiu	['voiceless, labio-dental, oral, fricative']
